"Kod";"Nazwa";"ogółem;ogółem;2012;[osoba]";"ogółem;ogółem;2013;[osoba]";"ogółem;ogółem;2014;[osoba]";"ogółem;ogółem;2015;[osoba]";"w wieku przedprodukcyjnym;ogółem;2012;[osoba]";"w wieku przedprodukcyjnym;ogółem;2013;[osoba]";"w wieku przedprodukcyjnym;ogółem;2014;[osoba]";"w wieku przedprodukcyjnym;ogółem;2015;[osoba]";"w wieku produkcyjnym;ogółem;2012;[osoba]";"w wieku produkcyjnym;ogółem;2013;[osoba]";"w wieku produkcyjnym;ogółem;2014;[osoba]";"w wieku produkcyjnym;ogółem;2015;[osoba]";"w wieku produkcyjnym mobilnym;ogółem;2012;[osoba]";"w wieku produkcyjnym mobilnym;ogółem;2013;[osoba]";"w wieku produkcyjnym mobilnym;ogółem;2014;[osoba]";"w wieku produkcyjnym mobilnym;ogółem;2015;[osoba]";"w wieku produkcyjnym niemobilnym;ogółem;2012;[osoba]";"w wieku produkcyjnym niemobilnym;ogółem;2013;[osoba]";"w wieku produkcyjnym niemobilnym;ogółem;2014;[osoba]";"w wieku produkcyjnym niemobilnym;ogółem;2015;[osoba]";"w wieku poprodukcyjnym;ogółem;2012;[osoba]";"w wieku poprodukcyjnym;ogółem;2013;[osoba]";"w wieku poprodukcyjnym;ogółem;2014;[osoba]";"w wieku poprodukcyjnym;ogółem;2015;[osoba]";
0201011;"Bolesławiec (1)";39851;39603;39464;39373;6299;6205;6186;6117;25160;24720;24307;23955;14932;14784;14645;14633;10228;9936;9662;9322;8392;8678;8971;9301;
0201022;"Bolesławiec (2)";13899;13995;14092;14104;2873;2823;2792;2707;9302;9364;9381;9362;5794;5811;5845;5833;3508;3553;3536;3529;1724;1808;1919;2035;
0201032;"Gromadka (2)";5519;5496;5483;5438;1045;1007;971;946;3633;3607;3580;3529;2237;2237;2255;2266;1396;1370;1325;1263;841;882;932;963;
0201043;"Nowogrodziec (3)";15285;15240;15250;15281;3134;3068;3034;3004;10028;9970;9941;9943;6363;6346;6338;6310;3665;3624;3603;3633;2123;2202;2275;2334;
0201044;"Nowogrodziec - miasto (4)";4236;4230;4227;4259;753;739;729;737;2852;2829;2801;2811;1748;1746;1744;1743;1104;1083;1057;1068;631;662;697;711;
0201045;"Nowogrodziec - obszar wiejski (5)";11049;11010;11023;11022;2381;2329;2305;2267;7176;7141;7140;7132;4615;4600;4594;4567;2561;2541;2546;2565;1492;1540;1578;1623;
0201052;"Osiecznica (2)";7542;7553;7558;7490;1723;1686;1664;1601;4905;4899;4888;4823;3358;3353;3348;3299;1547;1546;1540;1524;914;968;1006;1066;
0201062;"Warta Bolesławiecka (2)";8324;8419;8499;8513;1666;1645;1688;1674;5497;5541;5517;5507;3420;3476;3467;3468;2077;2065;2050;2039;1161;1233;1294;1332;
0202011;"Bielawa (1)";31480;31186;30987;30652;4802;4682;4639;4530;20210;19857;19469;19040;11927;11783;11587;11420;8283;8074;7882;7620;6468;6647;6879;7082;
0202021;"Dzierżoniów (1)";34679;34428;34168;33946;5167;5109;4990;5005;21857;21488;21079;20573;12755;12630;12444;12174;9102;8858;8635;8399;7655;7831;8099;8368;
0202031;"Pieszyce (1)";9678;9626;9586;9628;1744;1691;1651;1639;6196;6155;6085;6074;3730;3716;3704;3754;2466;2439;2381;2320;1738;1780;1850;1915;
0202041;"Piława Górna (1)";6749;6696;6702;6633;1200;1178;1172;1132;4411;4369;4358;4282;2704;2675;2660;2618;1707;1694;1698;1664;1138;1149;1172;1219;
0202052;"Dzierżoniów (2)";9353;9339;9335;9250;1617;1583;1577;1547;6227;6169;6131;6009;3717;3714;3730;3683;2510;2455;2401;2326;1509;1587;1627;1694;
0202062;"Łagiewniki (2)";7540;7538;7531;7541;1394;1376;1359;1361;4936;4895;4852;4809;2990;3005;3015;3015;1946;1890;1837;1794;1210;1267;1320;1371;
0202073;"Niemcza (3)";5805;5800;5766;5699;956;936;903;873;3775;3736;3687;3635;2245;2228;2204;2176;1530;1508;1483;1459;1074;1128;1176;1191;
0202074;"Niemcza - miasto (4)";3123;3121;3107;3062;471;465;443;414;1996;1965;1938;1915;1178;1155;1134;1132;818;810;804;783;656;691;726;733;
0202075;"Niemcza - obszar wiejski (5)";2682;2679;2659;2637;485;471;460;459;1779;1771;1749;1720;1067;1073;1070;1044;712;698;679;676;418;437;450;458;
0203011;"Głogów (1)";69185;68997;68836;68666;12281;12187;12174;12058;45389;44412;43484;42508;27483;27334;27082;26785;17906;17078;16402;15723;11515;12398;13178;14100;
0203022;"Głogów (2)";6450;6437;6438;6538;1398;1339;1268;1287;4263;4274;4280;4315;2642;2630;2647;2683;1621;1644;1633;1632;789;824;890;936;
0203032;"Jerzmanowa (2)";4449;4597;4666;4743;1095;1110;1125;1109;2876;2975;3009;3063;1947;2005;2024;2053;929;970;985;1010;478;512;532;571;
0203042;"Kotla (2)";4380;4391;4438;4461;963;948;963;965;2805;2815;2808;2814;1773;1782;1794;1812;1032;1033;1014;1002;612;628;667;682;
0203052;"Pęcław (2)";2335;2327;2315;2281;535;507;486;477;1494;1504;1507;1470;947;962;972;951;547;542;535;519;306;316;322;334;
0203062;"Żukowice (2)";3587;3553;3529;3516;729;698;686;684;2356;2335;2316;2280;1451;1460;1452;1424;905;875;864;856;502;520;527;552;
0204013;"Góra (3)";20786;20694;20554;20426;4134;3962;3877;3776;13271;13192;12991;12843;8202;8247;8116;8072;5069;4945;4875;4771;3381;3540;3686;3807;
0204014;"Góra - miasto (4)";12492;12403;12316;12217;2301;2195;2145;2074;8077;7981;7831;7717;4835;4826;4731;4698;3242;3155;3100;3019;2114;2227;2340;2426;
0204015;"Góra - obszar wiejski (5)";8294;8291;8238;8209;1833;1767;1732;1702;5194;5211;5160;5126;3367;3421;3385;3374;1827;1790;1775;1752;1267;1313;1346;1381;
0204022;"Jemielno (2)";3176;3154;3171;3130;649;632;635;625;2025;2010;1991;1955;1283;1276;1273;1265;742;734;718;690;502;512;545;550;
0204032;"Niechlów (2)";5157;5087;5114;5004;1099;1017;1013;976;3258;3263;3264;3185;2000;2005;1995;1954;1258;1258;1269;1231;800;807;837;843;
0204043;"Wąsosz (3)";7506;7456;7397;7380;1580;1535;1493;1484;4739;4701;4649;4595;2953;2916;2877;2875;1786;1785;1772;1720;1187;1220;1255;1301;
0204044;"Wąsosz - miasto (4)";2819;2807;2774;2771;594;589;574;565;1790;1770;1731;1717;1144;1129;1105;1099;646;641;626;618;435;448;469;489;
0204045;"Wąsosz - obszar wiejski (5)";4687;4649;4623;4609;986;946;919;919;2949;2931;2918;2878;1809;1787;1772;1776;1140;1144;1146;1102;752;772;786;812;
0205011;"Jawor (1)";24096;23937;23767;23650;3840;3760;3712;3634;16123;15800;15456;15157;9432;9330;9155;9082;6691;6470;6301;6075;4133;4377;4599;4859;
0205023;"Bolków (3)";10998;10872;10823;10716;1959;1895;1873;1831;7018;6903;6826;6711;4190;4139;4135;4075;2828;2764;2691;2636;2021;2074;2124;2174;
0205024;"Bolków - miasto (4)";5409;5314;5253;5155;822;790;770;736;3429;3351;3292;3223;2012;1973;1950;1901;1417;1378;1342;1322;1158;1173;1191;1196;
0205025;"Bolków - obszar wiejski (5)";5589;5558;5570;5561;1137;1105;1103;1095;3589;3552;3534;3488;2178;2166;2185;2174;1411;1386;1349;1314;863;901;933;978;
0205032;"Męcinka (2)";4958;4968;4991;4971;1034;1011;993;980;3141;3146;3153;3137;1970;1988;1986;1989;1171;1158;1167;1148;783;811;845;854;
0205042;"Mściwojów (2)";4177;4181;4160;4125;787;787;778;752;2679;2675;2639;2610;1649;1659;1638;1623;1030;1016;1001;987;711;719;743;763;
0205052;"Paszowice (2)";4026;4015;3996;3988;756;722;720;709;2635;2644;2634;2632;1640;1645;1637;1637;995;999;997;995;635;649;642;647;
0205062;"Wądroże Wielkie (2)";4101;4097;4059;4001;828;821;789;751;2599;2581;2555;2544;1597;1588;1597;1584;1002;993;958;960;674;695;715;706;
0206011;"Karpacz (1)";5007;4968;4921;4882;702;687;663;653;3366;3299;3239;3172;1880;1835;1822;1799;1486;1464;1417;1373;939;982;1019;1057;
0206021;"Kowary (1)";11648;11537;11408;11287;1929;1858;1825;1782;7521;7385;7187;7011;4394;4367;4280;4247;3127;3018;2907;2764;2198;2294;2396;2494;
0206031;"Piechowice (1)";6508;6494;6483;6443;1034;1023;1013;986;4220;4157;4112;4044;2473;2451;2418;2397;1747;1706;1694;1647;1254;1314;1358;1413;
0206041;"Szklarska Poręba (1)";6897;6864;6829;6703;941;937;903;862;4566;4491;4429;4289;2555;2508;2512;2443;2011;1983;1917;1846;1390;1436;1497;1552;
0206052;"Janowice Wielkie (2)";4291;4341;4338;4319;672;682;679;682;2903;2911;2873;2829;1719;1741;1721;1687;1184;1170;1152;1142;716;748;786;808;
0206062;"Jeżów Sudecki (2)";6931;7088;7102;7146;1353;1368;1353;1352;4604;4669;4639;4617;2809;2888;2867;2855;1795;1781;1772;1762;974;1051;1110;1177;
0206072;"Mysłakowice (2)";10225;10279;10250;10275;1879;1872;1810;1811;6692;6671;6625;6576;4036;4071;4021;3988;2656;2600;2604;2588;1654;1736;1815;1888;
0206082;"Podgórzyn (2)";8235;8272;8329;8270;1377;1365;1331;1275;5403;5370;5358;5293;3178;3182;3221;3153;2225;2188;2137;2140;1455;1537;1640;1702;
0206092;"Stara Kamienica (2)";5387;5328;5309;5274;956;933;904;894;3647;3558;3531;3455;2219;2180;2180;2164;1428;1378;1351;1291;784;837;874;925;
0207011;"Kamienna Góra (1)";20342;20014;19889;19663;3406;3232;3171;3100;12713;12467;12283;12049;7473;7373;7335;7221;5240;5094;4948;4828;4223;4315;4435;4514;
0207022;"Kamienna Góra (2)";9007;9038;8984;9010;1815;1811;1749;1726;5974;5973;5936;5911;3639;3649;3654;3648;2335;2324;2282;2263;1218;1254;1299;1373;
0207033;"Lubawka (3)";11477;11345;11205;11144;2041;1943;1857;1803;7403;7277;7170;7102;4416;4375;4334;4335;2987;2902;2836;2767;2033;2125;2178;2239;
0207034;"Lubawka - miasto (4)";6396;6317;6236;6192;1123;1073;1030;1003;4070;3988;3914;3877;2413;2378;2348;2352;1657;1610;1566;1525;1203;1256;1292;1312;
0207035;"Lubawka - obszar wiejski (5)";5081;5028;4969;4952;918;870;827;800;3333;3289;3256;3225;2003;1997;1986;1983;1330;1292;1270;1242;830;869;886;927;
0207042;"Marciszów (2)";4661;4642;4622;4585;857;827;812;798;3046;3042;3005;2954;1815;1826;1819;1810;1231;1216;1186;1144;758;773;805;833;
0208011;"Duszniki-Zdrój (1)";4977;4899;4837;4787;759;712;702;678;3076;3021;2943;2859;1834;1827;1794;1759;1242;1194;1149;1100;1142;1166;1192;1250;
0208021;"Kłodzko (1)";28356;27997;27792;27656;4469;4302;4216;4178;17757;17366;17058;16746;10631;10478;10321;10246;7126;6888;6737;6500;6130;6329;6518;6732;
0208031;"Kudowa-Zdrój (1)";10350;10241;10249;10180;1689;1649;1627;1612;6544;6444;6387;6251;3908;3862;3846;3764;2636;2582;2541;2487;2117;2148;2235;2317;
0208041;"Nowa Ruda (1)";23475;23236;23030;22823;3540;3434;3348;3273;14847;14595;14324;14064;8376;8293;8190;8110;6471;6302;6134;5954;5088;5207;5358;5486;
0208051;"Polanica-Zdrój (1)";6706;6663;6599;6521;947;931;904;873;4131;4018;3946;3875;2350;2305;2262;2230;1781;1713;1684;1645;1628;1714;1749;1773;
0208063;"Bystrzyca Kłodzka (3)";19689;19549;19446;19340;3171;3089;3032;2985;12787;12561;12366;12107;7514;7515;7453;7404;5273;5046;4913;4703;3731;3899;4048;4248;
0208064;"Bystrzyca Kłodzka - miasto (4)";10552;10476;10389;10357;1708;1668;1622;1606;6662;6480;6353;6235;3983;3966;3925;3914;2679;2514;2428;2321;2182;2328;2414;2516;
0208065;"Bystrzyca Kłodzka - obszar wiejski (5)";9137;9073;9057;8983;1463;1421;1410;1379;6125;6081;6013;5872;3531;3549;3528;3490;2594;2532;2485;2382;1549;1571;1634;1732;
0208072;"Kłodzko (2)";17290;17372;17369;17234;3095;3088;3070;2999;11445;11467;11364;11153;7009;7050;7031;6951;4436;4417;4333;4202;2750;2817;2935;3082;
0208083;"Lądek-Zdrój (3)";8732;8606;8540;8474;1337;1275;1249;1183;5640;5500;5411;5342;3262;3196;3174;3180;2378;2304;2237;2162;1755;1831;1880;1949;
0208084;"Lądek-Zdrój - miasto (4)";6023;5917;5873;5804;858;815;801;762;3855;3729;3659;3592;2198;2138;2116;2108;1657;1591;1543;1484;1310;1373;1413;1450;
0208085;"Lądek-Zdrój - obszar wiejski (5)";2709;2689;2667;2670;479;460;448;421;1785;1771;1752;1750;1064;1058;1058;1072;721;713;694;678;445;458;467;499;
0208092;"Lewin Kłodzki (2)";1962;1937;1937;1938;340;330;321;331;1290;1285;1289;1270;801;796;790;774;489;489;499;496;332;322;327;337;
0208103;"Międzylesie (3)";7559;7492;7436;7366;1355;1292;1267;1239;4975;4895;4807;4721;2974;2977;2970;2927;2001;1918;1837;1794;1229;1305;1362;1406;
0208104;"Międzylesie - miasto (4)";2749;2723;2709;2678;478;452;444;431;1767;1745;1720;1674;1050;1056;1053;1027;717;689;667;647;504;526;545;573;
0208105;"Międzylesie - obszar wiejski (5)";4810;4769;4727;4688;877;840;823;808;3208;3150;3087;3047;1924;1921;1917;1900;1284;1229;1170;1147;725;779;817;833;
0208112;"Nowa Ruda (2)";12163;12054;11964;11879;2056;2007;1971;1941;7970;7865;7766;7683;4644;4608;4590;4565;3326;3257;3176;3118;2137;2182;2227;2255;
0208123;"Radków (3)";9432;9344;9299;9198;1637;1605;1563;1519;6220;6120;6069;5977;3691;3657;3645;3631;2529;2463;2424;2346;1575;1619;1667;1702;
0208124;"Radków - miasto (4)";2508;2485;2474;2447;418;411;396;376;1642;1608;1598;1580;976;955;950;942;666;653;648;638;448;466;480;491;
0208125;"Radków - obszar wiejski (5)";6924;6859;6825;6751;1219;1194;1167;1143;4578;4512;4471;4397;2715;2702;2695;2689;1863;1810;1776;1708;1127;1153;1187;1211;
0208133;"Stronie Śląskie (3)";7767;7774;7690;7623;1255;1228;1153;1105;5089;5020;4963;4888;2998;2975;2947;2911;2091;2045;2016;1977;1423;1526;1574;1630;
0208134;"Stronie Śląskie - miasto (4)";6005;6023;5934;5861;910;907;843;801;3913;3850;3789;3710;2264;2245;2217;2176;1649;1605;1572;1534;1182;1266;1302;1350;
0208135;"Stronie Śląskie - obszar wiejski (5)";1762;1751;1756;1762;345;321;310;304;1176;1170;1174;1178;734;730;730;735;442;440;444;443;241;260;272;280;
0208143;"Szczytna (3)";7490;7516;7484;7446;1223;1211;1229;1216;5066;5032;4892;4802;2945;2983;2943;2917;2121;2049;1949;1885;1201;1273;1363;1428;
0208144;"Szczytna - miasto (4)";5348;5363;5328;5281;815;810;823;801;3614;3589;3470;3391;2052;2077;2045;2022;1562;1512;1425;1369;919;964;1035;1089;
0208145;"Szczytna - obszar wiejski (5)";2142;2153;2156;2165;408;401;406;415;1452;1443;1422;1411;893;906;898;895;559;537;524;516;282;309;328;339;
0209011;"Chojnów (1)";14210;14071;13972;13825;2246;2198;2174;2143;9459;9246;9080;8893;5568;5485;5419;5330;3891;3761;3661;3563;2505;2627;2718;2789;
0209022;"Chojnów (2)";9468;9502;9496;9550;1807;1767;1732;1724;6127;6183;6167;6171;3769;3810;3825;3837;2358;2373;2342;2334;1534;1552;1597;1655;
0209032;"Krotoszyce (2)";3254;3256;3285;3263;655;657;652;638;2151;2133;2161;2134;1392;1383;1396;1390;759;750;765;744;448;466;472;491;
0209042;"Kunice (2)";6152;6270;6399;6559;1263;1254;1258;1294;4095;4186;4257;4313;2505;2555;2621;2674;1590;1631;1636;1639;794;830;884;952;
0209052;"Legnickie Pole (2)";5156;5129;5171;5179;948;933;937;938;3269;3227;3233;3206;1949;1937;1968;1963;1320;1290;1265;1243;939;969;1001;1035;
0209062;"Miłkowice (2)";6342;6427;6493;6531;1175;1178;1202;1215;4147;4169;4167;4156;2543;2598;2639;2650;1604;1571;1528;1506;1020;1080;1124;1160;
0209073;"Prochowice (3)";7533;7519;7499;7478;1454;1436;1408;1385;4964;4912;4852;4782;3032;3031;3013;2981;1932;1881;1839;1801;1115;1171;1239;1311;
0209074;"Prochowice - miasto (4)";3657;3649;3644;3635;672;672;673;669;2428;2376;2337;2294;1457;1446;1429;1422;971;930;908;872;557;601;634;672;
0209075;"Prochowice - obszar wiejski (5)";3876;3870;3855;3843;782;764;735;716;2536;2536;2515;2488;1575;1585;1584;1559;961;951;931;929;558;570;605;639;
0209082;"Ruja (2)";2710;2695;2711;2666;553;540;539;517;1650;1639;1636;1620;1013;1031;1036;1024;637;608;600;596;507;516;536;529;
0210011;"Lubań (1)";22108;21921;21785;21580;3544;3425;3356;3264;14117;13855;13599;13280;8441;8420;8346;8237;5676;5435;5253;5043;4447;4641;4830;5036;
0210021;"Świeradów-Zdrój (1)";4403;4342;4308;4261;716;694;702;691;2812;2734;2670;2598;1595;1578;1568;1564;1217;1156;1102;1034;875;914;936;972;
0210033;"Leśna (3)";10568;10489;10412;10387;2006;1936;1880;1855;6834;6800;6710;6603;4137;4136;4111;4089;2697;2664;2599;2514;1728;1753;1822;1929;
0210034;"Leśna - miasto (4)";4703;4654;4648;4606;848;794;777;747;2996;2969;2939;2890;1770;1772;1778;1758;1226;1197;1161;1132;859;891;932;969;
0210035;"Leśna - obszar wiejski (5)";5865;5835;5764;5781;1158;1142;1103;1108;3838;3831;3771;3713;2367;2364;2333;2331;1471;1467;1438;1382;869;862;890;960;
0210042;"Lubań (2)";6530;6554;6580;6616;1286;1261;1247;1243;4389;4393;4370;4358;2763;2781;2785;2791;1626;1612;1585;1567;855;900;963;1015;
0210053;"Olszyna (3)";6645;6625;6619;6540;1169;1150;1134;1087;4346;4309;4276;4190;2655;2661;2652;2606;1691;1648;1624;1584;1130;1166;1209;1263;
0210054;"Olszyna - miasto (4)";4476;4474;4469;4400;741;731;726;686;2935;2918;2887;2819;1777;1795;1780;1747;1158;1123;1107;1072;800;825;856;895;
0210055;"Olszyna - obszar wiejski (5)";2169;2151;2150;2140;428;419;408;401;1411;1391;1389;1371;878;866;872;859;533;525;517;512;330;341;353;368;
0210062;"Platerówka (2)";1655;1651;1657;1614;325;325;333;298;1092;1080;1071;1051;657;657;661;646;435;423;410;405;238;246;253;265;
0210072;"Siekierczyn (2)";4594;4535;4539;4535;886;833;810;788;3003;2981;2981;2973;1896;1882;1898;1896;1107;1099;1083;1077;705;721;748;774;
0211011;"Lubin (1)";74669;74053;73658;73352;12313;12176;12038;11954;48286;46927;45768;44776;29243;28824;28492;28053;19043;18103;17276;16723;14070;14950;15852;16622;
0211022;"Lubin (2)";14093;14435;14789;15056;2946;2978;3015;3033;9328;9543;9741;9852;5811;5993;6145;6180;3517;3550;3596;3672;1819;1914;2033;2171;
0211032;"Rudna (2)";7574;7649;7690;7699;1581;1588;1564;1550;4818;4869;4916;4912;3100;3131;3152;3122;1718;1738;1764;1790;1175;1192;1210;1237;
0211043;"Ścinawa (3)";10482;10375;10296;10212;1883;1827;1792;1741;6943;6816;6708;6618;4196;4124;4070;4045;2747;2692;2638;2573;1656;1732;1796;1853;
0211044;"Ścinawa - miasto (4)";5879;5798;5767;5721;1050;1003;975;951;3882;3779;3734;3662;2323;2275;2259;2242;1559;1504;1475;1420;947;1016;1058;1108;
0211045;"Ścinawa - obszar wiejski (5)";4603;4577;4529;4491;833;824;817;790;3061;3037;2974;2956;1873;1849;1811;1803;1188;1188;1163;1153;709;716;738;745;
0212013;"Gryfów Śląski (3)";10152;10077;10010;9873;1658;1584;1566;1485;6600;6548;6433;6333;3971;3968;3915;3860;2629;2580;2518;2473;1894;1945;2011;2055;
0212014;"Gryfów Śląski - miasto (4)";6988;6902;6863;6777;1083;1018;1011;967;4527;4473;4373;4289;2684;2668;2632;2587;1843;1805;1741;1702;1378;1411;1479;1521;
0212015;"Gryfów Śląski - obszar wiejski (5)";3164;3175;3147;3096;575;566;555;518;2073;2075;2060;2044;1287;1300;1283;1273;786;775;777;771;516;534;532;534;
0212023;"Lubomierz (3)";6250;6200;6166;6162;1169;1150;1114;1108;4137;4071;4030;3978;2538;2504;2520;2515;1599;1567;1510;1463;944;979;1022;1076;
0212024;"Lubomierz - miasto (4)";2009;1968;1949;1915;374;371;354;340;1306;1257;1244;1206;819;784;791;765;487;473;453;441;329;340;351;369;
0212025;"Lubomierz - obszar wiejski (5)";4241;4232;4217;4247;795;779;760;768;2831;2814;2786;2772;1719;1720;1729;1750;1112;1094;1057;1022;615;639;671;707;
0212033;"Lwówek Śląski (3)";17947;17798;17614;17536;3266;3190;3102;3063;11727;11539;11285;11116;7068;7012;6856;6826;4659;4527;4429;4290;2954;3069;3227;3357;
0212034;"Lwówek Śląski - miasto (4)";9338;9271;9115;9102;1551;1500;1417;1423;6044;5932;5740;5628;3519;3513;3424;3413;2525;2419;2316;2215;1743;1839;1958;2051;
0212035;"Lwówek Śląski - obszar wiejski (5)";8609;8527;8499;8434;1715;1690;1685;1640;5683;5607;5545;5488;3549;3499;3432;3413;2134;2108;2113;2075;1211;1230;1269;1306;
0212043;"Mirsk (3)";8883;8862;8820;8733;1535;1511;1444;1417;5821;5771;5711;5619;3409;3433;3433;3403;2412;2338;2278;2216;1527;1580;1665;1697;
0212044;"Mirsk - miasto (4)";4109;4053;4025;3998;676;660;633;613;2678;2620;2571;2552;1571;1562;1546;1552;1107;1058;1025;1000;755;773;821;833;
0212045;"Mirsk - obszar wiejski (5)";4774;4809;4795;4735;859;851;811;804;3143;3151;3140;3067;1838;1871;1887;1851;1305;1280;1253;1216;772;807;844;864;
0212053;"Wleń (3)";4429;4380;4404;4373;704;682;685;675;2979;2936;2934;2866;1708;1697;1715;1700;1271;1239;1219;1166;746;762;785;832;
0212054;"Wleń - miasto (4)";1855;1818;1829;1831;275;262;264;264;1246;1215;1208;1180;692;688;699;691;554;527;509;489;334;341;357;387;
0212055;"Wleń - obszar wiejski (5)";2574;2562;2575;2542;429;420;421;411;1733;1721;1726;1686;1016;1009;1016;1009;717;712;710;677;412;421;428;445;
0213012;"Cieszków (2)";4682;4692;4692;4678;975;975;981;985;3039;3014;2975;2939;1901;1887;1884;1857;1138;1127;1091;1082;668;703;736;754;
0213022;"Krośnice (2)";8226;8211;8194;8178;1705;1670;1635;1627;5267;5253;5186;5142;3329;3338;3326;3306;1938;1915;1860;1836;1254;1288;1373;1409;
0213033;"Milicz (3)";24559;24417;24380;24357;4885;4889;4859;4808;15541;15204;15019;14890;9794;9581;9493;9466;5747;5623;5526;5424;4133;4324;4502;4659;
0213034;"Milicz - miasto (4)";11874;11758;11669;11593;2172;2222;2197;2151;7420;7127;6952;6864;4544;4342;4256;4242;2876;2785;2696;2622;2282;2409;2520;2578;
0213035;"Milicz - obszar wiejski (5)";12685;12659;12711;12764;2713;2667;2662;2657;8121;8077;8067;8026;5250;5239;5237;5224;2871;2838;2830;2802;1851;1915;1982;2081;
0214011;"Oleśnica (1)";37334;37303;37355;37450;6514;6504;6524;6572;23513;23244;23039;22853;14969;14871;14741;14593;8544;8373;8298;8260;7307;7555;7792;8025;
0214023;"Bierutów (3)";10301;10277;10180;10112;1928;1902;1835;1779;6779;6720;6626;6561;4203;4195;4131;4106;2576;2525;2495;2455;1594;1655;1719;1772;
0214024;"Bierutów - miasto (4)";5038;5032;4980;4973;874;884;857;838;3349;3297;3232;3209;2022;2000;1961;1962;1327;1297;1271;1247;815;851;891;926;
0214025;"Bierutów - obszar wiejski (5)";5263;5245;5200;5139;1054;1018;978;941;3430;3423;3394;3352;2181;2195;2170;2144;1249;1228;1224;1208;779;804;828;846;
0214032;"Dobroszyce (2)";6371;6425;6452;6463;1298;1306;1294;1290;4168;4174;4178;4133;2621;2641;2637;2642;1547;1533;1541;1491;905;945;980;1040;
0214042;"Dziadowa Kłoda (2)";4654;4644;4635;4634;1010;1004;978;950;3042;3009;2981;2978;1979;1962;1976;1975;1063;1047;1005;1003;602;631;676;706;
0214053;"Międzybórz (3)";5143;5158;5139;5111;1116;1115;1093;1063;3295;3273;3245;3222;2188;2177;2158;2153;1107;1096;1087;1069;732;770;801;826;
0214054;"Międzybórz - miasto (4)";2377;2381;2346;2328;469;464;454;448;1548;1533;1481;1449;1011;1006;970;963;537;527;511;486;360;384;411;431;
0214055;"Międzybórz - obszar wiejski (5)";2766;2777;2793;2783;647;651;639;615;1747;1740;1764;1773;1177;1171;1188;1190;570;569;576;583;372;386;390;395;
0214062;"Oleśnica (2)";12580;12752;12880;12936;2568;2559;2531;2491;8458;8561;8634;8644;5470;5540;5589;5600;2988;3021;3045;3044;1554;1632;1715;1801;
0214073;"Syców (3)";16561;16561;16659;16771;3204;3144;3137;3152;10763;10714;10675;10616;6772;6746;6748;6740;3991;3968;3927;3876;2594;2703;2847;3003;
0214074;"Syców - miasto (4)";10452;10385;10407;10474;1832;1785;1780;1796;6812;6727;6638;6579;4181;4118;4097;4072;2631;2609;2541;2507;1808;1873;1989;2099;
0214075;"Syców - obszar wiejski (5)";6109;6176;6252;6297;1372;1359;1357;1356;3951;3987;4037;4037;2591;2628;2651;2668;1360;1359;1386;1369;786;830;858;904;
0214083;"Twardogóra (3)";13010;12968;13011;13009;2431;2399;2404;2378;8619;8506;8434;8340;5444;5398;5374;5339;3175;3108;3060;3001;1960;2063;2173;2291;
0214084;"Twardogóra - miasto (4)";6789;6762;6794;6796;1196;1164;1175;1160;4479;4417;4371;4307;2801;2788;2775;2751;1678;1629;1596;1556;1114;1181;1248;1329;
0214085;"Twardogóra - obszar wiejski (5)";6221;6206;6217;6213;1235;1235;1229;1218;4140;4089;4063;4033;2643;2610;2599;2588;1497;1479;1464;1445;846;882;925;962;
0215011;"Oława (1)";32091;32240;32356;32572;5634;5664;5615;5679;19955;19732;19544;19455;12778;12729;12726;12754;7177;7003;6818;6701;6502;6844;7197;7438;
0215022;"Domaniów (2)";5368;5327;5306;5281;1116;1083;1055;1041;3489;3462;3439;3398;2214;2197;2187;2165;1275;1265;1252;1233;763;782;812;842;
0215033;"Jelcz-Laskowice (3)";23053;23190;23152;23123;4300;4253;4246;4238;15769;15658;15379;15077;9609;9687;9626;9503;6160;5971;5753;5574;2984;3279;3527;3808;
0215034;"Jelcz-Laskowice - miasto (4)";15864;15959;15910;15853;2846;2844;2847;2829;11138;10999;10728;10452;6725;6749;6676;6599;4413;4250;4052;3853;1880;2116;2335;2572;
0215035;"Jelcz-Laskowice - obszar wiejski (5)";7189;7231;7242;7270;1454;1409;1399;1409;4631;4659;4651;4625;2884;2938;2950;2904;1747;1721;1701;1721;1104;1163;1192;1236;
0215042;"Oława (2)";15016;15036;15139;15088;3118;3077;3092;3012;9772;9764;9751;9716;6178;6183;6182;6142;3594;3581;3569;3574;2126;2195;2296;2360;
0216013;"Chocianów (3)";13143;13065;13026;12978;2530;2453;2433;2381;8681;8606;8504;8428;5346;5287;5242;5219;3335;3319;3262;3209;1932;2006;2089;2169;
0216014;"Chocianów - miasto (4)";8274;8194;8122;8073;1537;1490;1467;1444;5580;5504;5388;5320;3398;3350;3296;3273;2182;2154;2092;2047;1157;1200;1267;1309;
0216015;"Chocianów - obszar wiejski (5)";4869;4871;4904;4905;993;963;966;937;3101;3102;3116;3108;1948;1937;1946;1946;1153;1165;1170;1162;775;806;822;860;
0216022;"Gaworzyce (2)";3960;4019;4010;3977;852;843;833;800;2536;2595;2590;2555;1646;1697;1665;1646;890;898;925;909;572;581;587;622;
0216032;"Grębocice (2)";5336;5361;5353;5403;1152;1146;1109;1130;3394;3405;3395;3395;2172;2195;2181;2180;1222;1210;1214;1215;790;810;849;878;
0216043;"Polkowice (3)";27262;27318;27325;27387;5594;5501;5386;5369;17609;17563;17495;17398;11549;11539;11455;11308;6060;6024;6040;6090;4059;4254;4444;4620;
0216044;"Polkowice - miasto (4)";22691;22638;22558;22535;4571;4473;4358;4325;14671;14531;14390;14245;9628;9558;9419;9247;5043;4973;4971;4998;3449;3634;3810;3965;
0216045;"Polkowice - obszar wiejski (5)";4571;4680;4767;4852;1023;1028;1028;1044;2938;3032;3105;3153;1921;1981;2036;2061;1017;1051;1069;1092;610;620;634;655;
0216053;"Przemków (3)";8836;8797;8772;8622;1670;1602;1575;1524;5790;5793;5766;5627;3523;3540;3529;3435;2267;2253;2237;2192;1376;1402;1431;1471;
0216054;"Przemków - miasto (4)";6500;6484;6412;6317;1211;1160;1126;1089;4345;4353;4295;4197;2593;2615;2580;2521;1752;1738;1715;1676;944;971;991;1031;
0216055;"Przemków - obszar wiejski (5)";2336;2313;2360;2305;459;442;449;435;1445;1440;1471;1430;930;925;949;914;515;515;522;516;432;431;440;440;
0216062;"Radwanice (2)";4646;4680;4715;4690;972;965;970;966;3071;3084;3062;3022;1893;1911;1933;1916;1178;1173;1129;1106;603;631;683;702;
0217012;"Borów (2)";5267;5281;5323;5338;928;894;908;903;3448;3468;3469;3451;2149;2157;2135;2127;1299;1311;1334;1324;891;919;946;984;
0217022;"Kondratowice (2)";4541;4485;4471;4440;842;818;820;803;2988;2939;2873;2856;1847;1812;1795;1800;1141;1127;1078;1056;711;728;778;781;
0217032;"Przeworno (2)";5082;5035;4974;4913;935;889;868;849;3242;3228;3180;3120;1926;1915;1889;1860;1316;1313;1291;1260;905;918;926;944;
0217043;"Strzelin (3)";22179;22138;22133;22109;3842;3808;3778;3771;14377;14242;14072;13903;8745;8733;8691;8623;5632;5509;5381;5280;3960;4088;4283;4435;
0217044;"Strzelin - miasto (4)";12575;12556;12546;12498;1997;2004;2014;2019;8171;8017;7883;7732;4916;4883;4838;4780;3255;3134;3045;2952;2407;2535;2649;2747;
0217045;"Strzelin - obszar wiejski (5)";9604;9582;9587;9611;1845;1804;1764;1752;6206;6225;6189;6171;3829;3850;3853;3843;2377;2375;2336;2328;1553;1553;1634;1688;
0217053;"Wiązów (3)";7478;7454;7373;7365;1481;1450;1403;1387;4760;4752;4720;4694;2955;2967;2943;2952;1805;1785;1777;1742;1237;1252;1250;1284;
0217054;"Wiązów - miasto (4)";2341;2327;2299;2310;426;430;420;417;1518;1510;1511;1493;914;911;914;911;604;599;597;582;397;387;368;400;
0217055;"Wiązów - obszar wiejski (5)";5137;5127;5074;5055;1055;1020;983;970;3242;3242;3209;3201;2041;2056;2029;2041;1201;1186;1180;1160;840;865;882;884;
0218012;"Kostomłoty (2)";7185;7143;7157;7136;1384;1329;1338;1327;4745;4721;4702;4653;2985;2977;2944;2880;1760;1744;1758;1773;1056;1093;1117;1156;
0218022;"Malczyce (2)";6081;6064;6001;6008;1130;1104;1046;1038;4019;3975;3940;3927;2492;2478;2468;2458;1527;1497;1472;1469;932;985;1015;1043;
0218032;"Miękinia (2)";13829;14187;14482;14665;2818;2913;2966;3007;9238;9406;9507;9626;5878;6042;6154;6223;3360;3364;3353;3403;1773;1868;2009;2032;
0218043;"Środa Śląska (3)";19585;19676;19742;19719;3626;3570;3541;3512;12786;12805;12730;12591;8066;8102;8102;8054;4720;4703;4628;4537;3173;3301;3471;3616;
0218044;"Środa Śląska - miasto (4)";9278;9317;9342;9337;1686;1676;1665;1657;6000;5988;5909;5850;3756;3772;3766;3733;2244;2216;2143;2117;1592;1653;1768;1830;
0218045;"Środa Śląska - obszar wiejski (5)";10307;10359;10400;10382;1940;1894;1876;1855;6786;6817;6821;6741;4310;4330;4336;4321;2476;2487;2485;2420;1581;1648;1703;1786;
0218052;"Udanin (2)";5428;5375;5343;5309;975;935;912;892;3535;3502;3470;3439;2192;2195;2168;2159;1343;1307;1302;1280;918;938;961;978;
0219011;"Świdnica (1)";59737;59182;58802;58377;9295;9089;8928;8799;38128;37325;36620;35826;22690;22349;22087;21739;15438;14976;14533;14087;12314;12768;13254;13752;
0219021;"Świebodzice (1)";23306;23152;23197;23053;3905;3838;3824;3740;14935;14671;14520;14286;8951;8914;8894;8808;5984;5757;5626;5478;4466;4643;4853;5027;
0219032;"Dobromierz (2)";5381;5326;5312;5295;967;954;954;930;3565;3507;3493;3472;2191;2149;2146;2142;1374;1358;1347;1330;849;865;865;893;
0219043;"Jaworzyna Śląska (3)";10468;10446;10390;10356;1920;1901;1873;1827;6905;6840;6787;6731;4286;4281;4254;4205;2619;2559;2533;2526;1643;1705;1730;1798;
0219044;"Jaworzyna Śląska - miasto (4)";5261;5226;5191;5178;907;887;870;849;3446;3411;3386;3374;2116;2114;2100;2074;1330;1297;1286;1300;908;928;935;955;
0219045;"Jaworzyna Śląska - obszar wiejski (5)";5207;5220;5199;5178;1013;1014;1003;978;3459;3429;3401;3357;2170;2167;2154;2131;1289;1262;1247;1226;735;777;795;843;
0219052;"Marcinowice (2)";6480;6533;6530;6525;1268;1256;1244;1240;4320;4334;4286;4235;2701;2729;2694;2685;1619;1605;1592;1550;892;943;1000;1050;
0219063;"Strzegom (3)";26991;26825;26623;26418;4668;4547;4489;4379;17609;17437;17101;16818;10691;10628;10469;10363;6918;6809;6632;6455;4714;4841;5033;5221;
0219064;"Strzegom - miasto (4)";16881;16769;16643;16526;2830;2770;2745;2681;10902;10750;10514;10343;6592;6535;6428;6364;4310;4215;4086;3979;3149;3249;3384;3502;
0219065;"Strzegom - obszar wiejski (5)";10110;10056;9980;9892;1838;1777;1744;1698;6707;6687;6587;6475;4099;4093;4041;3999;2608;2594;2546;2476;1565;1592;1649;1719;
0219072;"Świdnica (2)";16719;16854;16979;17038;3208;3265;3256;3267;11103;11065;11096;11007;6842;6837;6912;6863;4261;4228;4184;4144;2408;2524;2627;2764;
0219083;"Żarów (3)";12655;12614;12605;12571;2329;2283;2273;2238;8273;8225;8121;8006;5109;5088;5069;5033;3164;3137;3052;2973;2053;2106;2211;2327;
0219084;"Żarów - miasto (4)";6949;6880;6893;6875;1216;1191;1188;1179;4504;4437;4373;4291;2787;2746;2730;2702;1717;1691;1643;1589;1229;1252;1332;1405;
0219085;"Żarów - obszar wiejski (5)";5706;5734;5712;5696;1113;1092;1085;1059;3769;3788;3748;3715;2322;2342;2339;2331;1447;1446;1409;1384;824;854;879;922;
0220013;"Oborniki Śląskie (3)";19558;19724;19797;19902;3631;3654;3601;3640;12588;12571;12549;12442;7858;7894;7901;7841;4730;4677;4648;4601;3339;3499;3647;3820;
0220014;"Oborniki Śląskie - miasto (4)";9016;9038;9070;9108;1500;1494;1493;1518;5720;5680;5647;5567;3563;3567;3555;3515;2157;2113;2092;2052;1796;1864;1930;2023;
0220015;"Oborniki Śląskie - obszar wiejski (5)";10542;10686;10727;10794;2131;2160;2108;2122;6868;6891;6902;6875;4295;4327;4346;4326;2573;2564;2556;2549;1543;1635;1717;1797;
0220023;"Prusice (3)";9377;9345;9339;9342;1883;1817;1798;1776;6233;6218;6160;6127;3951;3939;3926;3902;2282;2279;2234;2225;1261;1310;1381;1439;
0220024;"Prusice - miasto (4)";2268;2274;2256;2239;434;433;411;401;1530;1524;1508;1490;980;965;951;926;550;559;557;564;304;317;337;348;
0220025;"Prusice - obszar wiejski (5)";7109;7071;7083;7103;1449;1384;1387;1375;4703;4694;4652;4637;2971;2974;2975;2976;1732;1720;1677;1661;957;993;1044;1091;
0220033;"Trzebnica (3)";23322;23586;23711;23911;4567;4608;4571;4618;15044;15042;15029;14986;9551;9611;9665;9689;5493;5431;5364;5297;3711;3936;4111;4307;
0220034;"Trzebnica - miasto (4)";12741;12945;12970;13099;2250;2300;2291;2341;8155;8123;8047;8017;5055;5096;5094;5093;3100;3027;2953;2924;2336;2522;2632;2741;
0220035;"Trzebnica - obszar wiejski (5)";10581;10641;10741;10812;2317;2308;2280;2277;6889;6919;6982;6969;4496;4515;4571;4596;2393;2404;2411;2373;1375;1414;1479;1566;
0220042;"Wisznia Mała (2)";9572;9712;9848;9899;1898;1913;1912;1901;6484;6521;6557;6513;4023;4085;4110;4097;2461;2436;2447;2416;1190;1278;1379;1485;
0220052;"Zawonia (2)";5731;5786;5815;5837;1147;1162;1160;1131;3828;3828;3833;3819;2382;2391;2411;2420;1446;1437;1422;1399;756;796;822;887;
0220063;"Żmigród (3)";14992;14888;14848;14808;2905;2820;2761;2702;9710;9650;9578;9502;6063;6073;6020;5970;3647;3577;3558;3532;2377;2418;2509;2604;
0220064;"Żmigród - miasto (4)";6538;6485;6487;6487;1178;1168;1145;1120;4319;4264;4240;4205;2697;2679;2644;2617;1622;1585;1596;1588;1041;1053;1102;1162;
0220065;"Żmigród - obszar wiejski (5)";8454;8403;8361;8321;1727;1652;1616;1582;5391;5386;5338;5297;3366;3394;3376;3353;2025;1992;1962;1944;1336;1365;1407;1442;
0221011;"Boguszów-Gorce (1)";16417;16216;16055;15869;2718;2631;2565;2516;10530;10350;10170;9954;6242;6187;6103;6015;4288;4163;4067;3939;3169;3235;3320;3399;
0221021;"Jedlina-Zdrój (1)";5033;5000;4975;4970;861;834;829;831;3162;3115;3085;3035;1903;1894;1906;1885;1259;1221;1179;1150;1010;1051;1061;1104;
0221031;"Szczawno-Zdrój (1)";5882;5796;5754;5699;855;809;784;773;3625;3553;3518;3454;2082;2034;2032;1997;1543;1519;1486;1457;1402;1434;1452;1472;
0221042;"Czarny Bór (2)";4850;4838;4862;4840;970;950;950;932;3162;3149;3159;3121;1934;1931;1940;1913;1228;1218;1219;1208;718;739;753;787;
0221053;"Głuszyca (3)";9040;8917;8850;8791;1443;1379;1335;1304;5954;5827;5759;5680;3514;3446;3415;3384;2440;2381;2344;2296;1643;1711;1756;1807;
0221054;"Głuszyca - miasto (4)";6739;6635;6583;6526;1026;983;957;927;4419;4318;4259;4189;2589;2523;2492;2462;1830;1795;1767;1727;1294;1334;1367;1410;
0221055;"Głuszyca - obszar wiejski (5)";2301;2282;2267;2265;417;396;378;377;1535;1509;1500;1491;925;923;923;922;610;586;577;569;349;377;389;397;
0221063;"Mieroszów (3)";7212;7106;7087;6992;1168;1126;1126;1094;4633;4546;4489;4395;2744;2705;2672;2629;1889;1841;1817;1766;1411;1434;1472;1503;
0221064;"Mieroszów - miasto (4)";4328;4274;4248;4212;670;642;635;626;2836;2789;2764;2711;1677;1654;1641;1615;1159;1135;1123;1096;822;843;849;875;
0221065;"Mieroszów - obszar wiejski (5)";2884;2832;2839;2780;498;484;491;468;1797;1757;1725;1684;1067;1051;1031;1014;730;706;694;670;589;591;623;628;
0221072;"Stare Bogaczowice (2)";4245;4254;4247;4255;750;736;746;742;2803;2805;2781;2765;1672;1696;1675;1683;1131;1109;1106;1082;692;713;720;748;
0221082;"Walim (2)";5754;5707;5662;5607;947;938;916;898;3780;3715;3646;3563;2212;2187;2147;2100;1568;1528;1499;1463;1027;1054;1100;1146;
0221091;"Wałbrzych od 2003 do 2012 (1)";119171;;;;17810;;;;76313;;;;43530;;;;32783;;;;25048;;;;
0222013;"Brzeg Dolny (3)";16189;16078;16024;15980;2713;2660;2641;2627;10727;10555;10368;10180;6553;6475;6422;6335;4174;4080;3946;3845;2749;2863;3015;3173;
0222014;"Brzeg Dolny - miasto (4)";12657;12536;12458;12420;1996;1946;1936;1932;8388;8208;8008;7833;5076;4997;4933;4852;3312;3211;3075;2981;2273;2382;2514;2655;
0222015;"Brzeg Dolny - obszar wiejski (5)";3532;3542;3566;3560;717;714;705;695;2339;2347;2360;2347;1477;1478;1489;1483;862;869;871;864;476;481;501;518;
0222022;"Wińsko (2)";8602;8552;8513;8428;1621;1567;1536;1486;5458;5432;5391;5336;3350;3345;3323;3310;2108;2087;2068;2026;1523;1553;1586;1606;
0222033;"Wołów (3)";22917;22939;22902;22786;3961;3870;3820;3776;15004;14987;14813;14677;9205;9240;9179;9109;5799;5747;5634;5568;3952;4082;4269;4333;
0222034;"Wołów - miasto (4)";12640;12646;12578;12522;2106;2066;2042;2032;8220;8193;8040;7939;5082;5079;5011;4960;3138;3114;3029;2979;2314;2387;2496;2551;
0222035;"Wołów - obszar wiejski (5)";10277;10293;10324;10264;1855;1804;1778;1744;6784;6794;6773;6738;4123;4161;4168;4149;2661;2633;2605;2589;1638;1695;1773;1782;
0223012;"Czernica (2)";12530;13032;13357;13856;2817;2917;2961;3071;8094;8363;8531;8799;5268;5459;5565;5701;2826;2904;2966;3098;1619;1752;1865;1986;
0223022;"Długołęka (2)";25555;26535;27531;28501;5488;5687;5929;6178;16800;17306;17767;18269;10979;11462;11886;12239;5821;5844;5881;6030;3267;3542;3835;4054;
0223032;"Jordanów Śląski (2)";3138;3156;3149;3134;572;571;562;558;2100;2100;2101;2066;1333;1323;1328;1307;767;777;773;759;466;485;486;510;
0223043;"Kąty Wrocławskie (3)";21892;22318;22614;22910;4594;4705;4787;4760;14229;14404;14440;14610;9263;9403;9450;9602;4966;5001;4990;5008;3069;3209;3387;3540;
0223044;"Kąty Wrocławskie - miasto (4)";6264;6422;6549;6621;1227;1285;1330;1308;4032;4077;4089;4109;2627;2681;2725;2776;1405;1396;1364;1333;1005;1060;1130;1204;
0223045;"Kąty Wrocławskie - obszar wiejski (5)";15628;15896;16065;16289;3367;3420;3457;3452;10197;10327;10351;10501;6636;6722;6725;6826;3561;3605;3626;3675;2064;2149;2257;2336;
0223052;"Kobierzyce (2)";17684;18232;18642;19085;3937;4086;4198;4330;11648;11929;12163;12342;7972;8203;8340;8431;3676;3726;3823;3911;2099;2217;2281;2413;
0223062;"Mietków (2)";3864;3857;3881;3880;695;688;705;692;2523;2505;2499;2475;1543;1534;1533;1517;980;971;966;958;646;664;677;713;
0223073;"Sobótka (3)";12816;12793;12791;12825;2351;2300;2264;2284;8271;8185;8121;8064;5104;5107;5109;5084;3167;3078;3012;2980;2194;2308;2406;2477;
0223074;"Sobótka - miasto (4)";7050;6991;6978;6972;1228;1183;1187;1190;4483;4383;4306;4264;2721;2699;2682;2669;1762;1684;1624;1595;1339;1425;1485;1518;
0223075;"Sobótka - obszar wiejski (5)";5766;5802;5813;5853;1123;1117;1077;1094;3788;3802;3815;3800;2383;2408;2427;2415;1405;1394;1388;1385;855;883;921;959;
0223083;"Siechnice (3)";17397;18189;19045;19819;3451;3729;3983;4213;11620;11994;12424;12800;7715;8057;8445;8767;3905;3937;3979;4033;2326;2466;2638;2806;
0223084;"Siechnice - miasto (4)";5762;6063;6381;6791;1132;1258;1352;1477;4034;4152;4312;4523;2842;2958;3118;3316;1192;1194;1194;1207;596;653;717;791;
0223085;"Siechnice - obszar wiejski (5)";11635;12126;12664;13028;2319;2471;2631;2736;7586;7842;8112;8277;4873;5099;5327;5451;2713;2743;2785;2826;1730;1813;1921;2015;
0223092;"Żórawina (2)";9633;9784;9958;10135;1852;1894;1957;2000;6521;6574;6623;6673;4206;4239;4274;4338;2315;2335;2349;2335;1260;1316;1378;1462;
0224013;"Bardo (3)";5510;5521;5514;5433;885;878;874;849;3629;3621;3587;3494;2174;2200;2180;2141;1455;1421;1407;1353;996;1022;1053;1090;
0224014;"Bardo - miasto (4)";2736;2741;2705;2639;404;408;396;372;1799;1781;1737;1676;1060;1063;1032;1002;739;718;705;674;533;552;572;591;
0224015;"Bardo - obszar wiejski (5)";2774;2780;2809;2794;481;470;478;477;1830;1840;1850;1818;1114;1137;1148;1139;716;703;702;679;463;470;481;499;
0224022;"Ciepłowody (2)";3125;3111;3096;3113;548;540;525;524;2088;2066;2050;2032;1268;1255;1251;1241;820;811;799;791;489;505;521;557;
0224032;"Kamieniec Ząbkowicki (2)";8512;8462;8398;8316;1476;1454;1416;1391;5686;5609;5535;5397;3403;3386;3373;3323;2283;2223;2162;2074;1350;1399;1447;1528;
0224042;"Stoszowice (2)";5557;5516;5501;5492;970;961;929;937;3719;3644;3626;3574;2274;2237;2228;2203;1445;1407;1398;1371;868;911;946;981;
0224053;"Ząbkowice Śląskie (3)";22799;22631;22469;22277;3747;3647;3583;3461;14551;14320;14039;13830;8828;8717;8562;8504;5723;5603;5477;5326;4501;4664;4847;4986;
0224054;"Ząbkowice Śląskie - miasto (4)";15835;15707;15585;15403;2472;2423;2373;2284;9933;9736;9508;9310;5999;5896;5776;5685;3934;3840;3732;3625;3430;3548;3704;3809;
0224055;"Ząbkowice Śląskie - obszar wiejski (5)";6964;6924;6884;6874;1275;1224;1210;1177;4618;4584;4531;4520;2829;2821;2786;2819;1789;1763;1745;1701;1071;1116;1143;1177;
0224063;"Ziębice (3)";18089;17917;17793;17670;3077;3007;2988;2941;11515;11313;11126;10952;6888;6846;6760;6688;4627;4467;4366;4264;3497;3597;3679;3777;
0224064;"Ziębice - miasto (4)";9200;9117;9052;9000;1439;1396;1395;1381;5804;5697;5611;5518;3431;3418;3385;3332;2373;2279;2226;2186;1957;2024;2046;2101;
0224065;"Ziębice - obszar wiejski (5)";8889;8800;8741;8670;1638;1611;1593;1560;5711;5616;5515;5434;3457;3428;3375;3356;2254;2188;2140;2078;1540;1573;1633;1676;
0224073;"Złoty Stok (3)";4742;4717;4687;4670;768;759;748;725;3125;3072;2995;2976;1834;1804;1784;1788;1291;1268;1211;1188;849;886;944;969;
0224074;"Złoty Stok - miasto (4)";2941;2935;2902;2899;455;453;449;432;1921;1889;1818;1810;1123;1120;1091;1098;798;769;727;712;565;593;635;657;
0224075;"Złoty Stok - obszar wiejski (5)";1801;1782;1785;1771;313;306;299;293;1204;1183;1177;1166;711;684;693;690;493;499;484;476;284;293;309;312;
0225011;"Zawidów (1)";4356;4353;4315;4272;759;741;727;699;2867;2852;2794;2760;1768;1765;1731;1702;1099;1087;1063;1058;730;760;794;813;
0225021;"Zgorzelec (1)";32278;31890;31532;31350;4798;4567;4398;4356;20351;19886;19511;19126;11819;11659;11502;11358;8532;8227;8009;7768;7129;7437;7623;7868;
0225033;"Bogatynia (3)";24614;24410;24127;23915;4514;4383;4281;4220;16365;16111;15767;15448;9920;9827;9674;9508;6445;6284;6093;5940;3735;3916;4079;4247;
0225034;"Bogatynia - miasto (4)";18566;18486;18299;18117;3304;3234;3164;3123;12442;12256;11997;11725;7475;7424;7312;7173;4967;4832;4685;4552;2820;2996;3138;3269;
0225035;"Bogatynia - obszar wiejski (5)";6048;5924;5828;5798;1210;1149;1117;1097;3923;3855;3770;3723;2445;2403;2362;2335;1478;1452;1408;1388;915;920;941;978;
0225043;"Pieńsk (3)";9351;9315;9274;9241;1714;1651;1611;1590;6141;6099;6049;5975;3838;3842;3827;3797;2303;2257;2222;2178;1496;1565;1614;1676;
0225044;"Pieńsk - miasto (4)";5964;5937;5943;5940;1063;1022;1011;1012;3891;3850;3826;3777;2407;2419;2427;2408;1484;1431;1399;1369;1010;1065;1106;1151;
0225045;"Pieńsk - obszar wiejski (5)";3387;3378;3331;3301;651;629;600;578;2250;2249;2223;2198;1431;1423;1400;1389;819;826;823;809;486;500;508;525;
0225052;"Sulików (2)";6119;6141;6114;6112;1210;1196;1175;1158;4049;4038;3986;3965;2487;2507;2480;2473;1562;1531;1506;1492;860;907;953;989;
0225063;"Węgliniec (3)";8739;8687;8608;8539;1577;1523;1462;1448;5696;5654;5596;5486;3369;3385;3342;3310;2327;2269;2254;2176;1466;1510;1550;1605;
0225064;"Węgliniec - miasto (4)";3049;3030;2984;2946;512;500;467;461;2010;1975;1940;1879;1157;1147;1122;1096;853;828;818;783;527;555;577;606;
0225065;"Węgliniec - obszar wiejski (5)";5690;5657;5624;5593;1065;1023;995;987;3686;3679;3656;3607;2212;2238;2220;2214;1474;1441;1436;1393;939;955;973;999;
0225072;"Zgorzelec (2)";8344;8362;8419;8395;1541;1535;1528;1469;5682;5651;5641;5592;3422;3407;3430;3424;2260;2244;2211;2168;1121;1176;1250;1334;
0226011;"Wojcieszów (1)";3895;3864;3814;3760;683;681;656;653;2551;2524;2461;2412;1551;1541;1519;1488;1000;983;942;924;661;659;697;695;
0226021;"Złotoryja (1)";16406;16167;16085;15951;2712;2548;2495;2437;10963;10736;10539;10299;6509;6453;6399;6328;4454;4283;4140;3971;2731;2883;3051;3215;
0226032;"Pielgrzymka (2)";4695;4636;4638;4680;939;898;872;882;3116;3085;3079;3088;1915;1909;1918;1930;1201;1176;1161;1158;640;653;687;710;
0226043;"Świerzawa (3)";7824;7766;7745;7683;1418;1402;1372;1366;5216;5125;5072;4976;3170;3131;3131;3101;2046;1994;1941;1875;1190;1239;1301;1341;
0226044;"Świerzawa - miasto (4)";2409;2376;2339;2333;383;382;353;356;1628;1578;1543;1511;961;934;936;936;667;644;607;575;398;416;443;466;
0226045;"Świerzawa - obszar wiejski (5)";5415;5390;5406;5350;1035;1020;1019;1010;3588;3547;3529;3465;2209;2197;2195;2165;1379;1350;1334;1300;792;823;858;875;
0226052;"Zagrodno (2)";5516;5484;5451;5404;992;980;949;924;3636;3606;3568;3532;2235;2212;2184;2160;1401;1394;1384;1372;888;898;934;948;
0226062;"Złotoryja (2)";7096;7139;7134;7120;1363;1374;1343;1338;4752;4740;4721;4649;2935;2940;2952;2927;1817;1800;1769;1722;981;1025;1070;1133;
0261011;"Jelenia Góra (1)";82846;81985;81408;81010;11998;11716;11705;11613;52552;51309;50087;48983;30395;29870;29407;29053;22157;21439;20680;19930;18296;18960;19616;20414;
0262011;"Legnica (1)";102422;101992;101343;100886;16933;16675;16428;16325;66252;65333;64109;62999;40118;39900;39402;38926;26134;25433;24707;24073;19237;19984;20806;21562;
0264011;"Wrocław (1)";631188;632067;634487;635759;93184;94232;96257;98253;406420;401817;397974;393121;260356;260573;260907;259954;146064;141244;137067;133167;131584;136018;140256;144385;
0265011;"Wałbrzych od 2013 (1)";;117926;116691;115453;;17381;17080;16808;;74748;73120;71364;;43079;42538;41842;;31669;30582;29522;;25797;26491;27281;
0401011;"Aleksandrów Kujawski (1)";12540;12515;12487;12370;2305;2267;2244;2205;8066;7995;7900;7728;4992;4998;4946;4813;3074;2997;2954;2915;2169;2253;2343;2437;
0401021;"Ciechocinek (1)";10791;10791;10719;10683;1598;1553;1548;1536;6389;6354;6230;6081;3634;3640;3581;3544;2755;2714;2649;2537;2804;2884;2941;3066;
0401031;"Nieszawa (1)";1993;1975;1975;1953;361;340;328;322;1289;1280;1282;1252;771;775;772;758;518;505;510;494;343;355;365;379;
0401042;"Aleksandrów Kujawski (2)";11576;11621;11624;11684;2470;2430;2392;2365;7516;7535;7535;7594;4837;4859;4860;4899;2679;2676;2675;2695;1590;1656;1697;1725;
0401052;"Bądkowo (2)";4450;4445;4413;4391;899;891;858;843;2772;2756;2739;2729;1738;1736;1725;1725;1034;1020;1014;1004;779;798;816;819;
0401062;"Koneck (2)";3303;3259;3226;3233;663;623;594;574;2041;2027;2014;2032;1253;1242;1241;1267;788;785;773;765;599;609;618;627;
0401072;"Raciążek (2)";3170;3154;3151;3133;564;545;534;510;2058;2046;2030;2010;1225;1222;1240;1235;833;824;790;775;548;563;587;613;
0401082;"Waganiec (2)";4575;4562;4547;4581;943;914;877;871;2973;2971;2964;2978;1924;1924;1903;1920;1049;1047;1061;1058;659;677;706;732;
0401092;"Zakrzewo (2)";3636;3597;3569;3545;691;667;637;617;2283;2271;2270;2261;1404;1386;1384;1390;879;885;886;871;662;659;662;667;
0402011;"Brodnica (1)";28580;28579;28605;28471;5609;5637;5569;5500;18481;18254;18102;17845;11664;11549;11550;11373;6817;6705;6552;6472;4490;4688;4934;5126;
0402022;"Bobrowo (2)";6282;6328;6375;6401;1341;1332;1313;1304;3948;3981;4019;4042;2531;2565;2596;2617;1417;1416;1423;1425;993;1015;1043;1055;
0402032;"Brodnica (2)";7492;7597;7733;7915;1758;1740;1773;1812;4904;4998;5076;5162;3275;3337;3378;3464;1629;1661;1698;1698;830;859;884;941;
0402042;"Brzozie (2)";3769;3766;3787;3773;878;874;881;858;2354;2338;2321;2333;1553;1547;1535;1522;801;791;786;811;537;554;585;582;
0402053;"Górzno (3)";4003;3989;4013;4016;820;815;813;805;2556;2543;2563;2570;1623;1620;1626;1628;933;923;937;942;627;631;637;641;
0402054;"Górzno - miasto (4)";1415;1410;1430;1431;271;268;281;278;907;905;914;914;563;563;560;573;344;342;354;341;237;237;235;239;
0402055;"Górzno - obszar wiejski (5)";2588;2579;2583;2585;549;547;532;527;1649;1638;1649;1656;1060;1057;1066;1055;589;581;583;601;390;394;402;402;
0402062;"Bartniczka (2)";4697;4714;4708;4733;1080;1073;1054;1061;2953;2963;2961;2974;1945;1964;1984;1974;1008;999;977;1000;664;678;693;698;
0402073;"Jabłonowo Pomorskie (3)";9116;9073;9062;9032;1933;1860;1830;1790;5724;5727;5706;5687;3631;3646;3659;3631;2093;2081;2047;2056;1459;1486;1526;1555;
0402074;"Jabłonowo Pomorskie - miasto (4)";3831;3824;3848;3809;781;753;751;727;2432;2444;2453;2423;1515;1534;1547;1511;917;910;906;912;618;627;644;659;
0402075;"Jabłonowo Pomorskie - obszar wiejski (5)";5285;5249;5214;5223;1152;1107;1079;1063;3292;3283;3253;3264;2116;2112;2112;2120;1176;1171;1141;1144;841;859;882;896;
0402082;"Osiek (2)";4096;4098;4103;4077;885;865;857;835;2551;2557;2575;2568;1650;1669;1655;1652;901;888;920;916;660;676;671;674;
0402092;"Świedziebnia (2)";5260;5209;5234;5204;1158;1113;1107;1081;3296;3282;3287;3279;2176;2142;2158;2164;1120;1140;1129;1115;806;814;840;844;
0402102;"Zbiczno (2)";4708;4749;4777;4809;985;968;959;980;3051;3065;3066;3058;1922;1951;1947;1939;1129;1114;1119;1119;672;716;752;771;
0403012;"Białe Błota (2)";18693;19215;19608;20161;4380;4451;4452;4568;12246;12549;12797;13083;7974;8144;8271;8420;4272;4405;4526;4663;2067;2215;2359;2510;
0403022;"Dąbrowa Chełmińska (2)";7926;7978;8033;8115;1726;1714;1700;1695;5173;5197;5230;5254;3315;3335;3339;3382;1858;1862;1891;1872;1027;1067;1103;1166;
0403032;"Dobrcz (2)";10608;10810;11010;11141;2369;2417;2380;2365;6778;6881;7025;7077;4350;4428;4533;4561;2428;2453;2492;2516;1461;1512;1605;1699;
0403043;"Koronowo (3)";24089;24137;24179;24211;4794;4725;4678;4636;15660;15600;15556;15466;9843;9849;9848;9768;5817;5751;5708;5698;3635;3812;3945;4109;
0403044;"Koronowo - miasto (4)";11360;11384;11384;11352;2139;2101;2074;2055;7532;7496;7435;7343;4651;4632;4625;4558;2881;2864;2810;2785;1689;1787;1875;1954;
0403045;"Koronowo - obszar wiejski (5)";12729;12753;12795;12859;2655;2624;2604;2581;8128;8104;8121;8123;5192;5217;5223;5210;2936;2887;2898;2913;1946;2025;2070;2155;
0403052;"Nowa Wieś Wielka (2)";9557;9637;9778;9836;2075;2016;1989;1973;6279;6326;6420;6420;4038;4076;4143;4110;2241;2250;2277;2310;1203;1295;1369;1443;
0403062;"Osielsko (2)";11970;12278;12569;12922;2799;2837;2875;2905;7853;8005;8149;8328;4984;5057;5123;5235;2869;2948;3026;3093;1318;1436;1545;1689;
0403072;"Sicienko (2)";9702;9755;9798;9839;2072;2040;2014;1986;6335;6374;6383;6408;4211;4198;4182;4155;2124;2176;2201;2253;1295;1341;1401;1445;
0403083;"Solec Kujawski (3)";16805;16755;16759;16767;3304;3203;3159;3152;10709;10665;10630;10515;6899;6868;6872;6785;3810;3797;3758;3730;2792;2887;2970;3100;
0403084;"Solec Kujawski - miasto (4)";15697;15642;15627;15616;3039;2940;2890;2884;9980;9935;9895;9772;6414;6384;6383;6288;3566;3551;3512;3484;2678;2767;2842;2960;
0403085;"Solec Kujawski - obszar wiejski (5)";1108;1113;1132;1151;265;263;269;268;729;730;735;743;485;484;489;497;244;246;246;246;114;120;128;140;
0404011;"Chełmno (1)";20813;20622;20434;20215;3765;3661;3573;3464;13385;13173;12906;12652;8295;8147;7986;7838;5090;5026;4920;4814;3663;3788;3955;4099;
0404022;"Chełmno (2)";5576;5687;5760;5820;1309;1335;1316;1307;3554;3611;3691;3743;2348;2397;2434;2457;1206;1214;1257;1286;713;741;753;770;
0404032;"Kijewo Królewskie (2)";4423;4443;4458;4474;975;958;949;940;2834;2834;2856;2860;1816;1829;1853;1864;1018;1005;1003;996;614;651;653;674;
0404042;"Lisewo (2)";5303;5307;5320;5314;1115;1094;1080;1082;3433;3445;3436;3410;2160;2169;2171;2156;1273;1276;1265;1254;755;768;804;822;
0404052;"Papowo Biskupie (2)";4414;4356;4365;4358;943;880;886;873;2838;2821;2791;2774;1824;1813;1780;1771;1014;1008;1011;1003;633;655;688;711;
0404062;"Stolno (2)";5212;5192;5203;5199;1152;1133;1127;1089;3391;3386;3376;3378;2173;2173;2166;2160;1218;1213;1210;1218;669;673;700;732;
0404072;"Unisław (2)";7013;7003;7019;6981;1451;1456;1423;1386;4510;4467;4474;4446;2870;2833;2850;2830;1640;1634;1624;1616;1052;1080;1122;1149;
0405011;"Golub-Dobrzyń (1)";13014;12945;12879;12849;2581;2538;2465;2447;8504;8367;8270;8173;5351;5272;5219;5146;3153;3095;3051;3027;1929;2040;2144;2229;
0405022;"Ciechocin (2)";4015;4043;4044;4016;923;901;863;827;2484;2527;2537;2521;1601;1629;1630;1620;883;898;907;901;608;615;644;668;
0405032;"Golub-Dobrzyń (2)";8405;8484;8541;8621;1781;1762;1734;1722;5379;5458;5484;5510;3369;3429;3463;3517;2010;2029;2021;1993;1245;1264;1323;1389;
0405043;"Kowalewo Pomorskie (3)";11611;11630;11636;11560;2405;2362;2326;2269;7331;7358;7348;7283;4728;4733;4709;4652;2603;2625;2639;2631;1875;1910;1962;2008;
0405044;"Kowalewo Pomorskie - miasto (4)";4270;4261;4266;4213;804;780;755;741;2716;2699;2710;2645;1712;1713;1725;1687;1004;986;985;958;750;782;801;827;
0405045;"Kowalewo Pomorskie - obszar wiejski (5)";7341;7369;7370;7347;1601;1582;1571;1528;4615;4659;4638;4638;3016;3020;2984;2965;1599;1639;1654;1673;1125;1128;1161;1181;
0405052;"Radomin (2)";3934;3918;3925;3916;786;768;745;721;2488;2484;2503;2478;1560;1553;1554;1557;928;931;949;921;660;666;677;717;
0405062;"Zbójno (2)";4470;4460;4416;4380;1025;1007;977;937;2701;2708;2709;2691;1734;1749;1730;1722;967;959;979;969;744;745;730;752;
0406012;"Grudziądz (2)";11930;11989;12148;12363;2628;2597;2630;2639;7721;7720;7794;7907;4911;4894;4937;5044;2810;2826;2857;2863;1581;1672;1724;1817;
0406022;"Gruta (2)";6597;6572;6568;6535;1365;1330;1299;1288;4258;4232;4212;4161;2648;2636;2644;2600;1610;1596;1568;1561;974;1010;1057;1086;
0406033;"Łasin (3)";8270;8237;8179;8125;1696;1642;1596;1584;5307;5276;5211;5138;3344;3318;3286;3237;1963;1958;1925;1901;1267;1319;1372;1403;
0406034;"Łasin - miasto (4)";3405;3377;3372;3387;638;612;612;638;2175;2149;2131;2110;1320;1306;1293;1278;855;843;838;832;592;616;629;639;
0406035;"Łasin - obszar wiejski (5)";4865;4860;4807;4738;1058;1030;984;946;3132;3127;3080;3028;2024;2012;1993;1959;1108;1115;1087;1069;675;703;743;764;
0406043;"Radzyń Chełmiński (3)";4889;4841;4826;4803;1104;1066;1043;1017;3123;3093;3076;3039;1996;1965;1950;1928;1127;1128;1126;1111;662;682;707;747;
0406044;"Radzyń Chełmiński - miasto (4)";1912;1894;1911;1889;364;359;360;357;1248;1218;1222;1192;774;757;758;743;474;461;464;449;300;317;329;340;
0406045;"Radzyń Chełmiński - obszar wiejski (5)";2977;2947;2915;2914;740;707;683;660;1875;1875;1854;1847;1222;1208;1192;1185;653;667;662;662;362;365;378;407;
0406052;"Rogóźno (2)";4187;4204;4178;4196;976;978;946;938;2587;2579;2574;2581;1673;1693;1694;1697;914;886;880;884;624;647;658;677;
0406062;"Świecie nad Osą (2)";4346;4292;4308;4324;1031;990;985;974;2736;2714;2716;2719;1721;1709;1706;1708;1015;1005;1010;1011;579;588;607;631;
0407011;"Inowrocław (1)";75517;75001;74564;74258;12194;11913;11637;11545;49320;48510;47813;46953;29343;29015;28742;28306;19977;19495;19071;18647;14003;14578;15114;15760;
0407022;"Dąbrowa Biskupia (2)";5167;5176;5181;5130;1046;1025;1015;991;3337;3330;3306;3259;2126;2134;2134;2120;1211;1196;1172;1139;784;821;860;880;
0407033;"Gniewkowo (3)";14849;14831;14786;14660;2933;2895;2825;2737;9513;9457;9382;9280;6020;5999;5963;5902;3493;3458;3419;3378;2403;2479;2579;2643;
0407034;"Gniewkowo - miasto (4)";7368;7293;7278;7219;1393;1335;1317;1300;4623;4556;4502;4429;2935;2911;2889;2851;1688;1645;1613;1578;1352;1402;1459;1490;
0407035;"Gniewkowo - obszar wiejski (5)";7481;7538;7508;7441;1540;1560;1508;1437;4890;4901;4880;4851;3085;3088;3074;3051;1805;1813;1806;1800;1051;1077;1120;1153;
0407042;"Inowrocław (2)";11440;11538;11595;11613;2214;2217;2182;2103;7452;7481;7512;7554;4687;4714;4713;4730;2765;2767;2799;2824;1774;1840;1901;1956;
0407053;"Janikowo (3)";13609;13530;13498;13426;2479;2378;2338;2275;8923;8900;8857;8802;5435;5422;5361;5331;3488;3478;3496;3471;2207;2252;2303;2349;
0407054;"Janikowo - miasto (4)";9145;9079;9034;8983;1525;1469;1448;1407;6042;6007;5950;5901;3627;3616;3563;3518;2415;2391;2387;2383;1578;1603;1636;1675;
0407055;"Janikowo - obszar wiejski (5)";4464;4451;4464;4443;954;909;890;868;2881;2893;2907;2901;1808;1806;1798;1813;1073;1087;1109;1088;629;649;667;674;
0407063;"Kruszwica (3)";19988;19849;19718;19696;3665;3555;3520;3480;12927;12747;12582;12493;8007;7873;7721;7671;4920;4874;4861;4822;3396;3547;3616;3723;
0407064;"Kruszwica - miasto (4)";9214;9128;9039;9038;1541;1493;1473;1470;6055;5930;5837;5774;3675;3585;3498;3463;2380;2345;2339;2311;1618;1705;1729;1794;
0407065;"Kruszwica - obszar wiejski (5)";10774;10721;10679;10658;2124;2062;2047;2010;6872;6817;6745;6719;4332;4288;4223;4208;2540;2529;2522;2511;1778;1842;1887;1929;
0407073;"Pakość (3)";9939;9885;9869;9841;1893;1862;1823;1790;6444;6340;6304;6270;4019;3977;3956;3939;2425;2363;2348;2331;1602;1683;1742;1781;
0407074;"Pakość - miasto (4)";5790;5756;5712;5749;1051;1033;997;1001;3764;3695;3641;3653;2320;2294;2262;2277;1444;1401;1379;1376;975;1028;1074;1095;
0407075;"Pakość - obszar wiejski (5)";4149;4129;4157;4092;842;829;826;789;2680;2645;2663;2617;1699;1683;1694;1662;981;962;969;955;627;655;668;686;
0407082;"Rojewo (2)";4756;4755;4770;4730;1031;1013;998;955;3062;3066;3064;3048;1949;1951;1952;1930;1113;1115;1112;1118;663;676;708;727;
0407092;"Złotniki Kujawskie (2)";9136;9117;9186;9191;1765;1704;1714;1689;6086;6070;6080;6049;3878;3864;3889;3873;2208;2206;2191;2176;1285;1343;1392;1453;
0408011;"Lipno (1)";15077;14968;14772;14720;2975;2892;2757;2704;9708;9606;9475;9340;5996;5939;5864;5802;3712;3667;3611;3538;2394;2470;2540;2676;
0408022;"Bobrowniki (2)";3151;3172;3172;3146;721;708;671;646;2008;2024;2046;2042;1323;1333;1349;1345;685;691;697;697;422;440;455;458;
0408032;"Chrostkowo (2)";3021;2990;2972;2937;656;630;605;573;1867;1839;1831;1817;1185;1170;1168;1168;682;669;663;649;498;521;536;547;
0408043;"Dobrzyń nad Wisłą (3)";7942;7891;7842;7810;1581;1534;1505;1456;5121;5079;5048;5025;3193;3173;3132;3123;1928;1906;1916;1902;1240;1278;1289;1329;
0408044;"Dobrzyń nad Wisłą - miasto (4)";2294;2278;2256;2231;406;391;379;363;1502;1494;1477;1462;919;914;892;886;583;580;585;576;386;393;400;406;
0408045;"Dobrzyń nad Wisłą - obszar wiejski (5)";5648;5613;5586;5579;1175;1143;1126;1093;3619;3585;3571;3563;2274;2259;2240;2237;1345;1326;1331;1326;854;885;889;923;
0408052;"Kikół (2)";7337;7321;7351;7281;1624;1587;1567;1490;4613;4636;4651;4644;3038;3050;3058;3049;1575;1586;1593;1595;1100;1098;1133;1147;
0408062;"Lipno (2)";11657;11634;11776;11828;2671;2578;2577;2542;7345;7380;7476;7530;4817;4864;4914;4954;2528;2516;2562;2576;1641;1676;1723;1756;
0408073;"Skępe (3)";7790;7762;7657;7609;1695;1655;1577;1512;4863;4847;4795;4770;3038;3029;2977;2966;1825;1818;1818;1804;1232;1260;1285;1327;
0408074;"Skępe - miasto (4)";3688;3669;3623;3610;700;687;657;636;2399;2366;2322;2303;1431;1418;1404;1399;968;948;918;904;589;616;644;671;
0408075;"Skępe - obszar wiejski (5)";4102;4093;4034;3999;995;968;920;876;2464;2481;2473;2467;1607;1611;1573;1567;857;870;900;900;643;644;641;656;
0408082;"Tłuchowo (2)";4682;4689;4685;4664;1086;1059;1041;1019;2904;2935;2920;2916;1896;1904;1889;1903;1008;1031;1031;1013;692;695;724;729;
0408092;"Wielgie (2)";6817;6804;6814;6828;1521;1504;1486;1478;4324;4310;4331;4321;2817;2801;2813;2804;1507;1509;1518;1517;972;990;997;1029;
0409012;"Dąbrowa (2)";4716;4703;4697;4648;1007;966;950;900;3019;3027;3008;2986;1912;1912;1921;1890;1107;1115;1087;1096;690;710;739;762;
0409022;"Jeziora Wielkie (2)";5071;5053;4986;4960;962;943;897;872;3253;3240;3185;3145;2041;2019;1998;1975;1212;1221;1187;1170;856;870;904;943;
0409033;"Mogilno (3)";25038;24881;24871;24840;4834;4711;4647;4554;16042;15868;15819;15739;9914;9896;9879;9847;6128;5972;5940;5892;4162;4302;4405;4547;
0409034;"Mogilno - miasto (4)";12466;12369;12240;12185;2163;2099;2007;1967;8062;7953;7863;7752;4912;4888;4826;4755;3150;3065;3037;2997;2241;2317;2370;2466;
0409035;"Mogilno - obszar wiejski (5)";12572;12512;12631;12655;2671;2612;2640;2587;7980;7915;7956;7987;5002;5008;5053;5092;2978;2907;2903;2895;1921;1985;2035;2081;
0409043;"Strzelno (3)";12030;11953;11854;11806;2291;2245;2195;2156;7732;7659;7531;7471;4792;4752;4698;4638;2940;2907;2833;2833;2007;2049;2128;2179;
0409044;"Strzelno - miasto (4)";5858;5812;5747;5725;1051;1008;973;965;3779;3750;3665;3629;2281;2260;2230;2206;1498;1490;1435;1423;1028;1054;1109;1131;
0409045;"Strzelno - obszar wiejski (5)";6172;6141;6107;6081;1240;1237;1222;1191;3953;3909;3866;3842;2511;2492;2468;2432;1442;1417;1398;1410;979;995;1019;1048;
0410013;"Kcynia (3)";13674;13577;13548;13519;2862;2761;2686;2677;8739;8678;8630;8519;5507;5481;5489;5419;3232;3197;3141;3100;2073;2138;2232;2323;
0410014;"Kcynia - miasto (4)";4775;4738;4735;4704;890;876;871;852;3108;3072;3041;2991;1936;1905;1899;1878;1172;1167;1142;1113;777;790;823;861;
0410015;"Kcynia - obszar wiejski (5)";8899;8839;8813;8815;1972;1885;1815;1825;5631;5606;5589;5528;3571;3576;3590;3541;2060;2030;1999;1987;1296;1348;1409;1462;
0410023;"Mrocza (3)";9322;9322;9317;9309;2093;2031;1985;1991;5976;5995;5982;5927;3857;3865;3864;3827;2119;2130;2118;2100;1253;1296;1350;1391;
0410024;"Mrocza - miasto (4)";4390;4393;4377;4404;933;901;878;901;2874;2886;2860;2847;1852;1864;1851;1835;1022;1022;1009;1012;583;606;639;656;
0410025;"Mrocza - obszar wiejski (5)";4932;4929;4940;4905;1160;1130;1107;1090;3102;3109;3122;3080;2005;2001;2013;1992;1097;1108;1109;1088;670;690;711;735;
0410033;"Nakło nad Notecią (3)";32527;32466;32440;32289;6500;6414;6331;6185;20964;20813;20617;20410;13127;13052;12980;12883;7837;7761;7637;7527;5063;5239;5492;5694;
0410034;"Nakło nad Notecią - miasto (4)";19294;19193;19064;18930;3658;3630;3543;3458;12070;11908;11731;11563;7507;7419;7321;7233;4563;4489;4410;4330;3566;3655;3790;3909;
0410035;"Nakło nad Notecią - obszar wiejski (5)";13233;13273;13376;13359;2842;2784;2788;2727;8894;8905;8886;8847;5620;5633;5659;5650;3274;3272;3227;3197;1497;1584;1702;1785;
0410042;"Sadki (2)";7335;7322;7320;7318;1660;1640;1613;1572;4678;4668;4651;4657;3025;3018;3003;3003;1653;1650;1648;1654;997;1014;1056;1089;
0410053;"Szubin (3)";23981;24282;24311;24406;4959;4965;4903;4871;15569;15724;15661;15641;9956;10071;10020;9994;5613;5653;5641;5647;3453;3593;3747;3894;
0410054;"Szubin - miasto (4)";9487;9580;9551;9545;1782;1819;1792;1804;6087;6082;6023;5956;3847;3880;3831;3788;2240;2202;2192;2168;1618;1679;1736;1785;
0410055;"Szubin - obszar wiejski (5)";14494;14702;14760;14861;3177;3146;3111;3067;9482;9642;9638;9685;6109;6191;6189;6206;3373;3451;3449;3479;1835;1914;2011;2109;
0411011;"Radziejów (1)";5876;5817;5749;5695;1020;970;920;893;3818;3754;3702;3632;2261;2231;2198;2149;1557;1523;1504;1483;1038;1093;1127;1170;
0411022;"Bytoń (2)";3638;3591;3609;3608;644;631;618;606;2281;2239;2249;2247;1435;1395;1390;1388;846;844;859;859;713;721;742;755;
0411032;"Dobre (2)";5558;5486;5472;5465;982;924;898;893;3635;3591;3592;3563;2261;2216;2220;2205;1374;1375;1372;1358;941;971;982;1009;
0411042;"Osięciny (2)";7964;7890;7843;7807;1508;1463;1423;1383;5031;4960;4926;4899;3127;3073;3059;3032;1904;1887;1867;1867;1425;1467;1494;1525;
0411053;"Piotrków Kujawski (3)";9484;9437;9426;9370;1787;1731;1707;1656;6087;6061;6007;5983;3750;3734;3706;3668;2337;2327;2301;2315;1610;1645;1712;1731;
0411054;"Piotrków Kujawski - miasto (4)";4467;4448;4462;4444;792;767;761;736;2952;2942;2917;2912;1792;1787;1783;1769;1160;1155;1134;1143;723;739;784;796;
0411055;"Piotrków Kujawski - obszar wiejski (5)";5017;4989;4964;4926;995;964;946;920;3135;3119;3090;3071;1958;1947;1923;1899;1177;1172;1167;1172;887;906;928;935;
0411062;"Radziejów (2)";4409;4446;4432;4476;819;830;823;814;2800;2817;2793;2810;1752;1743;1727;1764;1048;1074;1066;1046;790;799;816;852;
0411072;"Topólka (2)";4976;4979;4979;4952;936;917;912;880;3183;3201;3176;3162;1934;1956;1944;1953;1249;1245;1232;1209;857;861;891;910;
0412011;"Rypin (1)";16859;16834;16739;16629;3242;3170;3116;3048;10891;10826;10664;10492;6557;6553;6477;6395;4334;4273;4187;4097;2726;2838;2959;3089;
0412022;"Brzuze (2)";5441;5417;5424;5360;1128;1099;1089;1069;3391;3380;3376;3308;2111;2109;2093;2050;1280;1271;1283;1258;922;938;959;983;
0412032;"Rogowo (2)";4883;4857;4856;4810;1047;1055;1040;1006;3026;3004;2989;2965;1852;1825;1821;1827;1174;1179;1168;1138;810;798;827;839;
0412042;"Rypin (2)";7373;7407;7422;7496;1638;1578;1566;1572;4568;4635;4645;4675;2925;3006;3003;3027;1643;1629;1642;1648;1167;1194;1211;1249;
0412052;"Skrwilno (2)";6136;6096;6120;6034;1282;1258;1224;1165;3756;3740;3768;3730;2395;2372;2411;2404;1361;1368;1357;1326;1098;1098;1128;1139;
0412062;"Wąpielsk (2)";4119;4112;4091;4055;873;855;837;810;2527;2525;2509;2499;1619;1627;1612;1585;908;898;897;914;719;732;745;746;
0413013;"Kamień Krajeński (3)";7030;7028;7004;7017;1535;1514;1481;1474;4486;4473;4445;4432;2824;2821;2821;2820;1662;1652;1624;1612;1009;1041;1078;1111;
0413014;"Kamień Krajeński - miasto (4)";2358;2358;2398;2408;458;458;459;467;1550;1537;1565;1552;938;946;980;970;612;591;585;582;350;363;374;389;
0413015;"Kamień Krajeński - obszar wiejski (5)";4672;4670;4606;4609;1077;1056;1022;1007;2936;2936;2880;2880;1886;1875;1841;1850;1050;1061;1039;1030;659;678;704;722;
0413023;"Sępólno Krajeńskie (3)";16110;16111;16087;16053;3273;3238;3192;3112;10283;10257;10163;10109;6435;6432;6396;6374;3848;3825;3767;3735;2554;2616;2732;2832;
0413024;"Sępólno Krajeńskie - miasto (4)";9287;9368;9361;9304;1721;1738;1709;1663;6003;6008;5956;5889;3681;3700;3694;3650;2322;2308;2262;2239;1563;1622;1696;1752;
0413025;"Sępólno Krajeńskie - obszar wiejski (5)";6823;6743;6726;6749;1552;1500;1483;1449;4280;4249;4207;4220;2754;2732;2702;2724;1526;1517;1505;1496;991;994;1036;1080;
0413032;"Sośno (2)";5165;5146;5079;5074;1122;1118;1081;1052;3264;3250;3199;3199;2088;2080;2056;2075;1176;1170;1143;1124;779;778;799;823;
0413043;"Więcbork (3)";13384;13351;13372;13357;2862;2747;2703;2665;8323;8336;8312;8252;5240;5254;5282;5267;3083;3082;3030;2985;2199;2268;2357;2440;
0413044;"Więcbork - miasto (4)";6013;5970;5994;5976;1168;1099;1074;1050;3731;3727;3733;3716;2310;2299;2336;2330;1421;1428;1397;1386;1114;1144;1187;1210;
0413045;"Więcbork - obszar wiejski (5)";7371;7381;7378;7381;1694;1648;1629;1615;4592;4609;4579;4536;2930;2955;2946;2937;1662;1654;1633;1599;1085;1124;1170;1230;
0414012;"Bukowiec (2)";5177;5186;5201;5169;1126;1108;1098;1071;3341;3346;3335;3289;2084;2085;2094;2080;1257;1261;1241;1209;710;732;768;809;
0414022;"Dragacz (2)";7158;7169;7202;7249;1468;1446;1444;1464;4676;4662;4651;4622;2912;2895;2890;2869;1764;1767;1761;1753;1014;1061;1107;1163;
0414032;"Drzycim (2)";5061;5032;5015;5011;1077;1032;1024;1009;3285;3286;3247;3223;2084;2078;2049;2048;1201;1208;1198;1175;699;714;744;779;
0414042;"Jeżewo (2)";8015;8031;8072;8093;1712;1722;1700;1686;5184;5147;5148;5122;3248;3225;3257;3253;1936;1922;1891;1869;1119;1162;1224;1285;
0414052;"Lniano (2)";4249;4232;4258;4302;917;909;885;899;2739;2715;2735;2734;1752;1729;1734;1758;987;986;1001;976;593;608;638;669;
0414063;"Nowe (3)";10731;10669;10589;10521;2000;1949;1895;1869;6951;6892;6824;6723;4328;4296;4253;4177;2623;2596;2571;2546;1780;1828;1870;1929;
0414064;"Nowe - miasto (4)";6229;6190;6118;6038;1054;1017;958;921;4006;3963;3906;3803;2448;2418;2376;2306;1558;1545;1530;1497;1169;1210;1254;1314;
0414065;"Nowe - obszar wiejski (5)";4502;4479;4471;4483;946;932;937;948;2945;2929;2918;2920;1880;1878;1877;1871;1065;1051;1041;1049;611;618;616;615;
0414072;"Osie (2)";5459;5443;5477;5453;1176;1128;1092;1083;3486;3491;3516;3490;2208;2226;2234;2190;1278;1265;1282;1300;797;824;869;880;
0414082;"Pruszcz (2)";9645;9660;9627;9642;2014;1974;1906;1879;6144;6156;6152;6138;3853;3874;3897;3902;2291;2282;2255;2236;1487;1530;1569;1625;
0414093;"Świecie (3)";34333;34324;34328;34183;6484;6362;6354;6248;22272;22104;21779;21441;13731;13668;13569;13420;8541;8436;8210;8021;5577;5858;6195;6494;
0414094;"Świecie - miasto (4)";26482;26395;26276;26091;4757;4648;4601;4497;17214;17007;16655;16345;10486;10416;10290;10145;6728;6591;6365;6200;4511;4740;5020;5249;
0414095;"Świecie - obszar wiejski (5)";7851;7929;8052;8092;1727;1714;1753;1751;5058;5097;5124;5096;3245;3252;3279;3275;1813;1845;1845;1821;1066;1118;1175;1245;
0414102;"Świekatowo (2)";3531;3532;3535;3576;781;759;723;706;2236;2236;2260;2301;1445;1453;1458;1484;791;783;802;817;514;537;552;569;
0414112;"Warlubie (2)";6590;6561;6548;6565;1431;1400;1368;1358;4231;4204;4172;4160;2700;2687;2671;2665;1531;1517;1501;1495;928;957;1008;1047;
0415011;"Chełmża (1)";15066;14967;14905;14854;2913;2829;2777;2726;9776;9704;9605;9531;6076;6056;6016;5972;3700;3648;3589;3559;2377;2434;2523;2597;
0415022;"Chełmża (2)";9738;9682;9795;9879;2087;2016;2017;2022;6226;6184;6240;6257;3992;3978;4041;4073;2234;2206;2199;2184;1425;1482;1538;1600;
0415032;"Czernikowo (2)";8912;8952;8984;9073;2032;2020;2007;2017;5664;5684;5698;5736;3791;3797;3779;3818;1873;1887;1919;1918;1216;1248;1279;1320;
0415042;"Lubicz (2)";18940;19069;19150;19238;4267;4210;4153;4149;12464;12540;12508;12493;8258;8257;8214;8150;4206;4283;4294;4343;2209;2319;2489;2596;
0415052;"Łubianka (2)";6496;6610;6690;6775;1504;1502;1485;1498;4173;4260;4315;4360;2723;2785;2832;2866;1450;1475;1483;1494;819;848;890;917;
0415062;"Łysomice (2)";9272;9418;9521;9685;2028;2037;2052;2130;6062;6169;6207;6236;3955;4031;4061;4059;2107;2138;2146;2177;1182;1212;1262;1319;
0415072;"Obrowo (2)";13672;14205;14858;15438;3335;3398;3568;3696;8823;9178;9532;9847;5951;6229;6474;6717;2872;2949;3058;3130;1514;1629;1758;1895;
0415082;"Wielka Nieszawka (2)";4813;4897;4954;4972;1105;1106;1089;1086;3035;3079;3116;3109;1931;1989;2012;1995;1104;1090;1104;1114;673;712;749;777;
0415092;"Zławieś Wielka (2)";12982;13172;13310;13483;3045;3041;3047;3057;8390;8459;8514;8593;5542;5606;5638;5626;2848;2853;2876;2967;1547;1672;1749;1833;
0416012;"Cekcyn (2)";6679;6678;6683;6699;1446;1407;1400;1386;4312;4328;4300;4301;2674;2674;2657;2680;1638;1654;1643;1621;921;943;983;1012;
0416022;"Gostycyn (2)";5264;5219;5233;5218;1155;1096;1090;1061;3351;3336;3323;3290;2079;2086;2098;2093;1272;1250;1225;1197;758;787;820;867;
0416032;"Kęsowo (2)";4495;4451;4440;4449;1000;962;943;909;2902;2872;2859;2861;1787;1765;1754;1780;1115;1107;1105;1081;593;617;638;679;
0416042;"Lubiewo (2)";5853;5900;5929;5907;1357;1329;1332;1291;3638;3690;3685;3658;2330;2375;2356;2348;1308;1315;1329;1310;858;881;912;958;
0416052;"Śliwice (2)";5585;5580;5642;5648;1289;1267;1257;1251;3537;3536;3565;3544;2256;2243;2265;2240;1281;1293;1300;1304;759;777;820;853;
0416063;"Tuchola (3)";20451;20455;20454;20460;4111;4135;4043;3997;13033;12921;12888;12778;7960;7870;7892;7882;5073;5051;4996;4896;3307;3399;3523;3685;
0416064;"Tuchola - miasto (4)";13990;13949;13935;13914;2694;2718;2660;2628;8929;8786;8750;8637;5342;5242;5260;5235;3587;3544;3490;3402;2367;2445;2525;2649;
0416065;"Tuchola - obszar wiejski (5)";6461;6506;6519;6546;1417;1417;1383;1369;4104;4135;4138;4141;2618;2628;2632;2647;1486;1507;1506;1494;940;954;998;1036;
0417011;"Wąbrzeźno (1)";14114;14040;13925;13887;2622;2533;2457;2402;8944;8901;8781;8685;5496;5459;5377;5330;3448;3442;3404;3355;2548;2606;2687;2800;
0417022;"Dębowa Łąka (2)";3242;3153;3164;3194;716;670;656;651;2000;1964;1995;2017;1316;1269;1292;1313;684;695;703;704;526;519;513;526;
0417032;"Książki (2)";4276;4304;4239;4240;862;856;840;825;2758;2769;2706;2690;1688;1707;1644;1645;1070;1062;1062;1045;656;679;693;725;
0417042;"Płużnica (2)";4941;4948;4902;4878;1008;999;956;921;3167;3164;3127;3112;1996;2028;2000;2009;1171;1136;1127;1103;766;785;819;845;
0417052;"Wąbrzeźno (2)";8656;8589;8627;8645;1906;1859;1852;1805;5506;5453;5465;5487;3507;3474;3498;3523;1999;1979;1967;1964;1244;1277;1310;1353;
0418011;"Kowal (1)";3538;3538;3538;3548;574;560;552;556;2394;2400;2380;2376;1459;1452;1442;1445;935;948;938;931;570;578;606;616;
0418022;"Baruchowo (2)";3560;3559;3556;3535;686;660;651;636;2230;2241;2237;2221;1409;1413;1401;1381;821;828;836;840;644;658;668;678;
0418032;"Boniewo (2)";3546;3508;3502;3484;740;710;695;662;2141;2122;2126;2131;1355;1352;1343;1345;786;770;783;786;665;676;681;691;
0418043;"Brześć Kujawski (3)";11618;11598;11593;11580;2206;2164;2125;2070;7455;7441;7433;7387;4581;4582;4560;4535;2874;2859;2873;2852;1957;1993;2035;2123;
0418044;"Brześć Kujawski - miasto (4)";4768;4728;4690;4709;862;850;843;818;3092;3065;3025;3026;1885;1865;1828;1833;1207;1200;1197;1193;814;813;822;865;
0418045;"Brześć Kujawski - obszar wiejski (5)";6850;6870;6903;6871;1344;1314;1282;1252;4363;4376;4408;4361;2696;2717;2732;2702;1667;1659;1676;1659;1143;1180;1213;1258;
0418052;"Choceń (2)";8101;8073;8007;8017;1569;1540;1483;1440;5152;5128;5110;5127;3222;3187;3170;3180;1930;1941;1940;1947;1380;1405;1414;1450;
0418063;"Chodecz (3)";6265;6206;6199;6178;1114;1073;1065;1056;4033;4006;3963;3929;2471;2445;2424;2423;1562;1561;1539;1506;1118;1127;1171;1193;
0418064;"Chodecz - miasto (4)";1921;1893;1901;1896;291;279;285;282;1309;1286;1266;1246;772;751;737;737;537;535;529;509;321;328;350;368;
0418065;"Chodecz - obszar wiejski (5)";4344;4313;4298;4282;823;794;780;774;2724;2720;2697;2683;1699;1694;1687;1686;1025;1026;1010;997;797;799;821;825;
0418072;"Fabianki (2)";9646;9687;9811;9901;1964;1946;1957;1933;6409;6416;6494;6515;3982;3946;3959;3951;2427;2470;2535;2564;1273;1325;1360;1453;
0418083;"Izbica Kujawska (3)";7881;7873;7817;7764;1631;1602;1547;1508;4943;4948;4914;4879;3103;3106;3100;3073;1840;1842;1814;1806;1307;1323;1356;1377;
0418084;"Izbica Kujawska - miasto (4)";2779;2762;2730;2695;505;484;452;438;1850;1842;1830;1804;1122;1104;1098;1067;728;738;732;737;424;436;448;453;
0418085;"Izbica Kujawska - obszar wiejski (5)";5102;5111;5087;5069;1126;1118;1095;1070;3093;3106;3084;3075;1981;2002;2002;2006;1112;1104;1082;1069;883;887;908;924;
0418092;"Kowal (2)";3999;3963;3957;3942;759;730;719;699;2511;2492;2501;2497;1532;1507;1509;1506;979;985;992;991;729;741;737;746;
0418102;"Lubanie (2)";4705;4646;4622;4618;930;882;862;835;3001;2979;2955;2952;1895;1868;1846;1851;1106;1111;1109;1101;774;785;805;831;
0418113;"Lubień Kujawski (3)";7568;7538;7506;7440;1458;1406;1362;1322;4750;4725;4712;4681;2965;2950;2952;2904;1785;1775;1760;1777;1360;1407;1432;1437;
0418114;"Lubień Kujawski - miasto (4)";1398;1401;1413;1404;246;238;241;240;910;908;901;889;549;557;562;552;361;351;339;337;242;255;271;275;
0418115;"Lubień Kujawski - obszar wiejski (5)";6170;6137;6093;6036;1212;1168;1121;1082;3840;3817;3811;3792;2416;2393;2390;2352;1424;1424;1421;1440;1118;1152;1161;1162;
0418123;"Lubraniec (3)";9854;9804;9773;9708;1826;1769;1724;1695;6132;6134;6100;6010;3732;3742;3728;3655;2400;2392;2372;2355;1896;1901;1949;2003;
0418124;"Lubraniec - miasto (4)";3159;3160;3139;3092;535;529;511;499;2023;2023;1997;1929;1164;1168;1162;1121;859;855;835;808;601;608;631;664;
0418125;"Lubraniec - obszar wiejski (5)";6695;6644;6634;6616;1291;1240;1213;1196;4109;4111;4103;4081;2568;2574;2566;2534;1541;1537;1537;1547;1295;1293;1318;1339;
0418132;"Włocławek (2)";6917;6927;6928;7043;1392;1380;1368;1348;4516;4516;4495;4594;2816;2789;2770;2847;1700;1727;1725;1747;1009;1031;1065;1101;
0419013;"Barcin (3)";15027;14975;14920;14865;2866;2817;2771;2698;9713;9585;9453;9355;6109;6068;6052;6021;3604;3517;3401;3334;2448;2573;2696;2812;
0419014;"Barcin - miasto (4)";7802;7752;7655;7614;1387;1358;1324;1303;4952;4818;4678;4583;3135;3104;3054;3014;1817;1714;1624;1569;1463;1576;1653;1728;
0419015;"Barcin - obszar wiejski (5)";7225;7223;7265;7251;1479;1459;1447;1395;4761;4767;4775;4772;2974;2964;2998;3007;1787;1803;1777;1765;985;997;1043;1084;
0419022;"Gąsawa (2)";5296;5264;5289;5244;1080;1054;1034;1004;3386;3369;3368;3327;2072;2063;2074;2042;1314;1306;1294;1285;830;841;887;913;
0419033;"Janowiec Wielkopolski (3)";9293;9256;9185;9172;1802;1801;1771;1753;5952;5880;5778;5722;3625;3595;3546;3538;2327;2285;2232;2184;1539;1575;1636;1697;
0419034;"Janowiec Wielkopolski - miasto (4)";4106;4088;4023;4012;725;736;712;700;2635;2582;2517;2471;1589;1560;1518;1511;1046;1022;999;960;746;770;794;841;
0419035;"Janowiec Wielkopolski - obszar wiejski (5)";5187;5168;5162;5160;1077;1065;1059;1053;3317;3298;3261;3251;2036;2035;2028;2027;1281;1263;1233;1224;793;805;842;856;
0419043;"Łabiszyn (3)";9792;9871;9909;9961;2075;2056;2025;2024;6377;6381;6381;6362;4080;4124;4137;4120;2297;2257;2244;2242;1340;1434;1503;1575;
0419044;"Łabiszyn - miasto (4)";4544;4531;4524;4533;868;857;832;831;3038;2987;2972;2929;1888;1875;1891;1868;1150;1112;1081;1061;638;687;720;773;
0419045;"Łabiszyn - obszar wiejski (5)";5248;5340;5385;5428;1207;1199;1193;1193;3339;3394;3409;3433;2192;2249;2246;2252;1147;1145;1163;1181;702;747;783;802;
0419052;"Rogowo (2)";6942;6931;6915;6929;1429;1410;1371;1394;4407;4371;4372;4324;2767;2746;2764;2740;1640;1625;1608;1584;1106;1150;1172;1211;
0419063;"Żnin (3)";24607;24495;24478;24435;4733;4635;4554;4476;15702;15537;15413;15312;9719;9649;9600;9564;5983;5888;5813;5748;4172;4323;4511;4647;
0419064;"Żnin - miasto (4)";14281;14181;14173;14153;2520;2446;2390;2370;9111;8965;8868;8774;5539;5486;5459;5429;3572;3479;3409;3345;2650;2770;2915;3009;
0419065;"Żnin - obszar wiejski (5)";10326;10314;10305;10282;2213;2189;2164;2106;6591;6572;6545;6538;4180;4163;4141;4135;2411;2409;2404;2403;1522;1553;1596;1638;
0461011;"Bydgoszcz (1)";361254;359428;357652;355645;56860;56451;56135;55757;229244;225507;221523;217487;141490;139916;138352;136352;87754;85591;83171;81135;75150;77470;79994;82401;
0462011;"Grudziądz (1)";97971;97676;97176;96319;17146;17164;16969;16672;62430;61460;60472;59278;37284;36869;36380;35822;25146;24591;24092;23456;18395;19052;19735;20369;
0463011;"Toruń (1)";204299;203447;203158;202689;33421;33402;33381;33384;132841;130466;128584;126388;83690;82638;82109;81069;49151;47828;46475;45319;38037;39579;41193;42917;
0464011;"Włocławek (1)";115546;114885;113939;113041;19024;18809;18493;18237;74012;72564;71077;69646;44559;43947;43120;42346;29453;28617;27957;27300;22510;23512;24369;25158;
0601011;"Międzyrzec Podlaski (1)";17223;17117;17102;17024;3299;3231;3214;3146;11155;11004;10898;10778;6874;6769;6722;6647;4281;4235;4176;4131;2769;2882;2990;3100;
0601021;"Terespol (1)";5840;5815;5794;5751;1118;1101;1064;1040;3731;3711;3704;3660;2333;2331;2316;2262;1398;1380;1388;1398;991;1003;1026;1051;
0601032;"Biała Podlaska (2)";13585;13784;13848;13945;3163;3138;3069;3031;8413;8605;8734;8831;5614;5755;5797;5867;2799;2850;2937;2964;2009;2041;2045;2083;
0601042;"Drelów (2)";5540;5540;5499;5475;1169;1126;1081;1090;3345;3377;3350;3326;2150;2195;2190;2154;1195;1182;1160;1172;1026;1037;1068;1059;
0601052;"Janów Podlaski (2)";5530;5493;5468;5469;1138;1157;1171;1134;3418;3362;3306;3310;2170;2109;2050;2076;1248;1253;1256;1234;974;974;991;1025;
0601062;"Kodeń (2)";3777;3782;3742;3692;692;680;646;625;2273;2285;2268;2238;1390;1401;1399;1390;883;884;869;848;812;817;828;829;
0601072;"Konstantynów (2)";4110;4094;4138;4136;853;837;852;836;2589;2583;2606;2604;1647;1653;1657;1652;942;930;949;952;668;674;680;696;
0601082;"Leśna Podlaska (2)";4348;4334;4334;4312;946;934;922;879;2681;2688;2679;2693;1752;1744;1744;1757;929;944;935;936;721;712;733;740;
0601092;"Łomazy (2)";5203;5156;5109;5084;1036;980;938;924;3060;3080;3078;3060;2013;2054;2055;2035;1047;1026;1023;1025;1107;1096;1093;1100;
0601102;"Międzyrzec Podlaski (2)";10507;10567;10539;10563;2448;2387;2296;2241;6394;6505;6552;6594;4238;4292;4319;4315;2156;2213;2233;2279;1665;1675;1691;1728;
0601112;"Piszczac (2)";7485;7436;7381;7357;1600;1527;1483;1446;4540;4553;4544;4546;2977;2992;2988;2998;1563;1561;1556;1548;1345;1356;1354;1365;
0601122;"Rokitno (2)";3177;3142;3097;3064;636;630;595;601;1876;1848;1841;1808;1178;1153;1149;1134;698;695;692;674;665;664;661;655;
0601132;"Rossosz (2)";2372;2349;2331;2295;478;452;440;413;1447;1449;1428;1421;924;931;917;912;523;518;511;509;447;448;463;461;
0601142;"Sławatycze (2)";2490;2450;2415;2362;494;461;436;415;1445;1436;1431;1395;877;894;901;897;568;542;530;498;551;553;548;552;
0601152;"Sosnówka (2)";2577;2553;2532;2526;433;410;395;390;1522;1512;1516;1502;902;914;941;925;620;598;575;577;622;631;621;634;
0601162;"Terespol (2)";6961;6876;6839;6782;1387;1339;1316;1283;4225;4198;4171;4128;2700;2669;2640;2605;1525;1529;1531;1523;1349;1339;1352;1371;
0601172;"Tuczna (2)";3300;3286;3246;3184;633;616;570;548;1823;1845;1846;1828;1120;1137;1144;1133;703;708;702;695;844;825;830;808;
0601182;"Wisznice (2)";5187;5122;5060;5031;1001;985;922;906;3184;3136;3143;3123;2007;1945;1954;1920;1177;1191;1189;1203;1002;1001;995;1002;
0601192;"Zalesie (2)";4460;4440;4427;4455;952;935;915;933;2669;2675;2692;2714;1700;1695;1704;1708;969;980;988;1006;839;830;820;808;
0602011;"Biłgoraj (1)";27252;27169;26935;26826;5285;5413;5279;5147;17584;17090;16734;16463;11076;10792;10616;10503;6508;6298;6118;5960;4383;4666;4922;5216;
0602022;"Aleksandrów (2)";3259;3240;3245;3279;782;748;723;727;1969;1981;2007;2031;1319;1333;1342;1350;650;648;665;681;508;511;515;521;
0602032;"Biłgoraj (2)";12972;13042;13138;13132;2711;2690;2697;2654;8310;8365;8412;8382;5379;5425;5474;5453;2931;2940;2938;2929;1951;1987;2029;2096;
0602042;"Biszcza (2)";3866;3887;3861;3844;722;724;704;699;2484;2497;2472;2437;1570;1577;1582;1573;914;920;890;864;660;666;685;708;
0602053;"Frampol (3)";6371;6328;6271;6257;1161;1104;1074;1057;3826;3813;3783;3766;2429;2414;2379;2389;1397;1399;1404;1377;1384;1411;1414;1434;
0602054;"Frampol - miasto (4)";1493;1482;1457;1459;255;242;231;227;957;945;924;917;575;565;547;544;382;380;377;373;281;295;302;315;
0602055;"Frampol - obszar wiejski (5)";4878;4846;4814;4798;906;862;843;830;2869;2868;2859;2849;1854;1849;1832;1845;1015;1019;1027;1004;1103;1116;1112;1119;
0602062;"Goraj (2)";4301;4283;4267;4192;746;718;709;675;2611;2606;2603;2575;1633;1647;1641;1631;978;959;962;944;944;959;955;942;
0602073;"Józefów (3)";7049;7024;6931;6925;1253;1145;1110;1106;4441;4491;4434;4397;2826;2850;2796;2777;1615;1641;1638;1620;1355;1388;1387;1422;
0602074;"Józefów - miasto (4)";2520;2520;2506;2509;441;394;381;388;1637;1662;1649;1637;1030;1043;1036;1032;607;619;613;605;442;464;476;484;
0602075;"Józefów - obszar wiejski (5)";4529;4504;4425;4416;812;751;729;718;2804;2829;2785;2760;1796;1807;1760;1745;1008;1022;1025;1015;913;924;911;938;
0602082;"Księżpol (2)";6886;6899;6891;6917;1472;1437;1394;1359;4358;4375;4394;4428;2828;2840;2839;2889;1530;1535;1555;1539;1056;1087;1103;1130;
0602092;"Łukowa (2)";4324;4292;4299;4292;904;850;839;803;2629;2648;2655;2680;1650;1648;1640;1670;979;1000;1015;1010;791;794;805;809;
0602102;"Obsza (2)";4334;4299;4307;4303;862;812;816;804;2731;2729;2717;2712;1759;1759;1747;1741;972;970;970;971;741;758;774;787;
0602112;"Potok Górny (2)";5523;5512;5511;5510;992;923;884;865;3479;3543;3574;3590;2212;2269;2268;2272;1267;1274;1306;1318;1052;1046;1053;1055;
0602123;"Tarnogród (3)";6883;6892;6857;6829;1347;1325;1288;1256;4341;4325;4291;4264;2757;2785;2764;2756;1584;1540;1527;1508;1195;1242;1278;1309;
0602124;"Tarnogród - miasto (4)";3467;3464;3457;3438;656;649;642;622;2274;2246;2223;2195;1410;1410;1401;1405;864;836;822;790;537;569;592;621;
0602125;"Tarnogród - obszar wiejski (5)";3416;3428;3400;3391;691;676;646;634;2067;2079;2068;2069;1347;1375;1363;1351;720;704;705;718;658;673;686;688;
0602132;"Tereszpol (2)";3991;3970;3959;3927;801;763;749;721;2496;2508;2510;2491;1555;1571;1574;1573;941;937;936;918;694;699;700;715;
0602142;"Turobin (2)";6558;6529;6469;6414;1031;1002;959;945;3741;3739;3718;3670;2184;2198;2200;2160;1557;1541;1518;1510;1786;1788;1792;1799;
0603011;"Rejowiec Fabryczny (1)";4545;4515;4486;4445;831;801;765;734;3010;2999;2992;2963;1854;1839;1824;1803;1156;1160;1168;1160;704;715;729;748;
0603022;"Białopole (2)";3184;3163;3134;3090;592;576;577;542;2004;1978;1938;1911;1263;1266;1235;1229;741;712;703;682;588;609;619;637;
0603032;"Chełm (2)";13772;13944;14146;14332;2785;2807;2812;2830;8956;9059;9164;9274;5801;5886;5947;6024;3155;3173;3217;3250;2031;2078;2170;2228;
0603042;"Dorohusk (2)";6774;6743;6685;6604;1261;1237;1207;1178;4286;4275;4236;4171;2700;2691;2673;2643;1586;1584;1563;1528;1227;1231;1242;1255;
0603052;"Dubienka (2)";2520;2524;2483;2494;434;454;439;464;1568;1553;1531;1510;944;937;919;907;624;616;612;603;518;517;513;520;
0603062;"Kamień (2)";4097;4081;4113;4098;863;822;816;787;2612;2629;2659;2677;1704;1720;1738;1746;908;909;921;931;622;630;638;634;
0603072;"Leśniowice (2)";3845;3800;3774;3729;733;702;695;675;2363;2339;2314;2286;1484;1469;1470;1464;879;870;844;822;749;759;765;768;
0603082;"Rejowiec Fabryczny (2)";4440;4393;4373;4354;835;796;774;768;2709;2701;2677;2658;1695;1696;1706;1685;1014;1005;971;973;896;896;922;928;
0603092;"Ruda-Huta (2)";4736;4684;4698;4677;956;901;903;893;2980;2977;2974;2951;1939;1944;1943;1916;1041;1033;1031;1035;800;806;821;833;
0603102;"Sawin (2)";5659;5668;5720;5636;1059;1071;1045;1040;3601;3597;3634;3540;2252;2246;2308;2253;1349;1351;1326;1287;999;1000;1041;1056;
0603112;"Siedliszcze (2)";6973;6959;6972;6969;1380;1357;1336;1328;4358;4364;4385;4368;2791;2789;2824;2822;1567;1575;1561;1546;1235;1238;1251;1273;
0603122;"Wierzbica (2)";5388;5344;5316;5250;1130;1085;1027;990;3404;3399;3409;3359;2143;2149;2159;2133;1261;1250;1250;1226;854;860;880;901;
0603132;"Wojsławice (2)";3978;3945;3899;3899;731;678;657;634;2404;2417;2392;2405;1498;1516;1502;1505;906;901;890;900;843;850;850;860;
0603142;"Żmudź (2)";3220;3215;3212;3204;632;621;600;600;2043;2044;2058;2047;1292;1295;1306;1292;751;749;752;755;545;550;554;557;
0603152;"Rejowiec (2)";6655;6595;6608;6596;1209;1178;1213;1179;4190;4135;4102;4124;2588;2537;2531;2544;1602;1598;1571;1580;1256;1282;1293;1293;
0604011;"Hrubieszów (1)";18731;18585;18450;18287;3268;3194;3130;3037;12145;11948;11705;11505;7388;7275;7185;7058;4757;4673;4520;4447;3318;3443;3615;3745;
0604022;"Dołhobyczów (2)";5904;5848;5758;5695;1014;992;956;921;3725;3664;3565;3520;2221;2196;2162;2149;1504;1468;1403;1371;1165;1192;1237;1254;
0604032;"Horodło (2)";5546;5494;5401;5331;975;945;915;895;3390;3359;3292;3240;2080;2086;2039;1995;1310;1273;1253;1245;1181;1190;1194;1196;
0604042;"Hrubieszów (2)";10445;10382;10292;10298;2105;2035;1947;1908;6318;6322;6312;6324;3982;3997;3983;4013;2336;2325;2329;2311;2022;2025;2033;2066;
0604052;"Mircze (2)";7639;7579;7527;7482;1299;1221;1177;1163;4544;4554;4506;4463;2694;2735;2719;2677;1850;1819;1787;1786;1796;1804;1844;1856;
0604062;"Trzeszczany (2)";4572;4548;4459;4373;800;783;745;703;2842;2833;2782;2719;1740;1751;1722;1674;1102;1082;1060;1045;930;932;932;951;
0604072;"Uchanie (2)";4891;4873;4847;4792;850;822;807;795;2959;2956;2934;2893;1836;1846;1836;1802;1123;1110;1098;1091;1082;1095;1106;1104;
0604082;"Werbkowice (2)";9934;9848;9778;9681;1821;1754;1706;1643;6198;6173;6123;6062;3899;3885;3844;3794;2299;2288;2279;2268;1915;1921;1949;1976;
0605012;"Batorz (2)";3453;3442;3414;3407;682;644;634;625;2004;2049;2038;2040;1279;1314;1293;1289;725;735;745;751;767;749;742;742;
0605022;"Chrzanów (2)";3027;3015;2997;2999;577;555;544;539;1716;1721;1703;1705;1096;1101;1093;1091;620;620;610;614;734;739;750;755;
0605032;"Dzwola (2)";6537;6514;6466;6424;1243;1201;1181;1153;3886;3905;3897;3888;2463;2493;2481;2463;1423;1412;1416;1425;1408;1408;1388;1383;
0605042;"Godziszów (2)";6139;6108;6049;5991;1273;1208;1173;1127;3585;3605;3588;3559;2273;2296;2297;2302;1312;1309;1291;1257;1281;1295;1288;1305;
0605053;"Janów Lubelski (3)";16326;16272;16288;16200;3066;2977;2929;2845;10634;10562;10497;10375;6603;6570;6515;6462;4031;3992;3982;3913;2626;2733;2862;2980;
0605054;"Janów Lubelski - miasto (4)";12145;12092;12110;12073;2277;2213;2179;2130;7999;7899;7834;7727;4879;4842;4817;4789;3120;3057;3017;2938;1869;1980;2097;2216;
0605055;"Janów Lubelski - obszar wiejski (5)";4181;4180;4178;4127;789;764;750;715;2635;2663;2663;2648;1724;1728;1698;1673;911;935;965;975;757;753;765;764;
0605062;"Modliborzyce (2)";7172;7126;;;1352;1306;;;4455;4467;;;2811;2811;;;1644;1656;;;1365;1353;;;
0605063;"Modliborzyce (3)";;;7109;7088;;;1271;1253;;;4469;4475;;;2818;2789;;;1651;1686;;;1369;1360;
0605064;"Modliborzyce - miasto (4)";;;1430;1449;;;253;257;;;875;882;;;543;544;;;332;338;;;302;310;
0605065;"Modliborzyce - obszar wiejski (5)";;;5679;5639;;;1018;996;;;3594;3593;;;2275;2245;;;1319;1348;;;1067;1050;
0605072;"Potok Wielki (2)";4846;4819;4783;4786;1004;967;944;936;2957;2968;2944;2950;1914;1925;1898;1906;1043;1043;1046;1044;885;884;895;900;
0606011;"Krasnystaw (1)";19588;19539;19343;19116;3284;3263;3179;3059;12552;12361;12100;11818;7552;7484;7313;7215;5000;4877;4787;4603;3752;3915;4064;4239;
0606022;"Fajsławice (2)";4761;4730;4703;4644;857;815;780;761;2916;2922;2925;2884;1833;1851;1850;1823;1083;1071;1075;1061;988;993;998;999;
0606032;"Gorzków (2)";3734;3692;3644;3620;543;521;507;517;2179;2146;2121;2086;1324;1314;1305;1281;855;832;816;805;1012;1025;1016;1017;
0606042;"Izbica (2)";8560;8504;8425;8372;1491;1475;1417;1399;5166;5103;5101;5067;3232;3227;3234;3226;1934;1876;1867;1841;1903;1926;1907;1906;
0606052;"Krasnystaw (2)";8899;8872;8826;8761;1616;1597;1544;1509;5607;5582;5559;5527;3487;3493;3503;3483;2120;2089;2056;2044;1676;1693;1723;1725;
0606062;"Kraśniczyn (2)";4003;3951;3883;3845;565;515;522;497;2375;2370;2326;2305;1360;1370;1345;1343;1015;1000;981;962;1063;1066;1035;1043;
0606072;"Łopiennik Górny (2)";4175;4115;4088;4049;753;710;685;667;2418;2423;2436;2423;1523;1520;1539;1530;895;903;897;893;1004;982;967;959;
0606092;"Rudnik (2)";3261;3210;3191;3158;565;535;518;518;1844;1828;1818;1779;1113;1108;1103;1100;731;720;715;679;852;847;855;861;
0606102;"Siennica Różana (2)";4206;4282;4249;4234;726;753;715;685;2608;2654;2653;2653;1622;1665;1660;1660;986;989;993;993;872;875;881;896;
0606112;"Żółkiewka (2)";5709;5664;5639;5623;923;874;847;859;3257;3252;3262;3254;1953;1973;1979;1974;1304;1279;1283;1280;1529;1538;1530;1510;
0607011;"Kraśnik (1)";36038;35788;35508;35233;5894;5754;5590;5425;22813;22418;22093;21681;13965;13814;13609;13394;8848;8604;8484;8287;7331;7616;7825;8127;
0607023;"Annopol (3)";9066;9036;8929;8855;1756;1672;1606;1584;5597;5608;5579;5530;3418;3467;3451;3433;2179;2141;2128;2097;1713;1756;1744;1741;
0607024;"Annopol - miasto (4)";2655;2664;2624;2608;524;521;502;500;1799;1789;1756;1726;1079;1087;1073;1065;720;702;683;661;332;354;366;382;
0607025;"Annopol - obszar wiejski (5)";6411;6372;6305;6247;1232;1151;1104;1084;3798;3819;3823;3804;2339;2380;2378;2368;1459;1439;1445;1436;1381;1402;1378;1359;
0607032;"Dzierzkowice (2)";5365;5414;5379;5319;1019;1025;999;976;3368;3368;3349;3306;2082;2106;2086;2044;1286;1262;1263;1262;978;1021;1031;1037;
0607042;"Gościeradów (2)";7428;7400;7380;7388;1502;1445;1398;1373;4556;4559;4574;4593;2887;2888;2909;2927;1669;1671;1665;1666;1370;1396;1408;1422;
0607052;"Kraśnik (2)";7386;7387;7392;7394;1495;1468;1437;1415;4629;4645;4672;4685;3009;3017;3021;3011;1620;1628;1651;1674;1262;1274;1283;1294;
0607062;"Szastarka (2)";5976;5957;5908;5893;1151;1102;1061;1061;3598;3632;3620;3604;2276;2305;2292;2282;1322;1327;1328;1322;1227;1223;1227;1228;
0607072;"Trzydnik Duży (2)";6748;6634;6579;6492;1230;1160;1130;1094;4122;4077;4028;3961;2642;2604;2562;2514;1480;1473;1466;1447;1396;1397;1421;1437;
0607082;"Urzędów (2)";8792;8787;8782;8773;1729;1697;1650;1626;5364;5341;5355;5329;3450;3447;3460;3450;1914;1894;1895;1879;1699;1749;1777;1818;
0607092;"Wilkołaz (2)";5519;5523;5567;5547;1118;1114;1110;1089;3373;3371;3391;3372;2147;2129;2154;2168;1226;1242;1237;1204;1028;1038;1066;1086;
0607102;"Zakrzówek (2)";6819;6823;6758;6675;1238;1199;1164;1134;4130;4168;4145;4085;2562;2598;2573;2519;1568;1570;1572;1566;1451;1456;1449;1456;
0608011;"Lubartów (1)";22654;22543;22463;22369;4054;4029;3996;3947;14971;14669;14392;14065;9177;9022;8929;8796;5794;5647;5463;5269;3629;3845;4075;4357;
0608022;"Abramów (2)";4179;4192;4182;4147;801;765;758;728;2500;2544;2550;2556;1612;1651;1651;1655;888;893;899;901;878;883;874;863;
0608032;"Firlej (2)";6050;6020;5969;5933;1266;1204;1179;1151;3653;3680;3660;3655;2375;2399;2359;2328;1278;1281;1301;1327;1131;1136;1130;1127;
0608042;"Jeziorzany (2)";2972;2945;2903;2856;548;517;502;488;1831;1835;1806;1769;1142;1151;1123;1093;689;684;683;676;593;593;595;599;
0608052;"Kamionka (2)";6435;6414;6396;6448;1327;1303;1261;1270;3967;3971;3982;4016;2609;2592;2587;2618;1358;1379;1395;1398;1141;1140;1153;1162;
0608063;"Kock (3)";6704;6667;6620;6568;1363;1334;1294;1259;4140;4139;4144;4108;2616;2617;2615;2599;1524;1522;1529;1509;1201;1194;1182;1201;
0608064;"Kock - miasto (4)";3436;3412;3389;3372;649;642;619;606;2204;2182;2189;2158;1331;1318;1311;1308;873;864;878;850;583;588;581;608;
0608065;"Kock - obszar wiejski (5)";3268;3255;3231;3196;714;692;675;653;1936;1957;1955;1950;1285;1299;1304;1291;651;658;651;659;618;606;601;593;
0608072;"Lubartów (2)";11086;11158;11245;11272;2445;2434;2421;2378;6974;7029;7081;7117;4664;4697;4700;4714;2310;2332;2381;2403;1667;1695;1743;1777;
0608082;"Michów (2)";6123;6140;6074;6059;1171;1119;1092;1088;3623;3702;3684;3683;2273;2348;2312;2293;1350;1354;1372;1390;1329;1319;1298;1288;
0608092;"Niedźwiada (2)";6301;6280;6263;6312;1332;1294;1269;1268;3854;3862;3864;3905;2550;2568;2530;2578;1304;1294;1334;1327;1115;1124;1130;1139;
0608103;"Ostrów Lubelski (3)";5446;5448;5428;5349;1054;1051;1026;969;3293;3296;3310;3270;2073;2081;2081;2066;1220;1215;1229;1204;1099;1101;1092;1110;
0608104;"Ostrów Lubelski - miasto (4)";2188;2207;2191;2146;380;413;396;355;1416;1397;1389;1367;854;841;846;842;562;556;543;525;392;397;406;424;
0608105;"Ostrów Lubelski - obszar wiejski (5)";3258;3241;3237;3203;674;638;630;614;1877;1899;1921;1903;1219;1240;1235;1224;658;659;686;679;707;704;686;686;
0608112;"Ostrówek (2)";4053;4026;3993;3976;878;869;839;835;2344;2320;2317;2307;1520;1525;1525;1509;824;795;792;798;831;837;837;834;
0608122;"Serniki (2)";4889;4896;4892;4906;995;978;950;949;3015;3032;3047;3039;1962;1975;1993;1985;1053;1057;1054;1054;879;886;895;918;
0608132;"Uścimów (2)";3348;3336;3321;3307;642;628;605;604;2048;2053;2055;2023;1314;1313;1319;1310;734;740;736;713;658;655;661;680;
0609013;"Bełżyce (3)";13553;13502;13426;13381;2631;2557;2515;2466;8663;8640;8537;8509;5546;5580;5534;5496;3117;3060;3003;3013;2259;2305;2374;2406;
0609014;"Bełżyce - miasto (4)";6810;6765;6700;6659;1253;1220;1203;1188;4481;4431;4333;4276;2840;2840;2795;2756;1641;1591;1538;1520;1076;1114;1164;1195;
0609015;"Bełżyce - obszar wiejski (5)";6743;6737;6726;6722;1378;1337;1312;1278;4182;4209;4204;4233;2706;2740;2739;2740;1476;1469;1465;1493;1183;1191;1210;1211;
0609022;"Borzechów (2)";3796;3843;3820;3787;750;739;715;693;2339;2393;2395;2364;1522;1556;1542;1528;817;837;853;836;707;711;710;730;
0609033;"Bychawa (3)";12166;12074;12048;11933;2377;2308;2248;2176;7506;7456;7456;7388;4834;4778;4770;4711;2672;2678;2686;2677;2283;2310;2344;2369;
0609034;"Bychawa - miasto (4)";5240;5178;5159;5052;1013;986;942;888;3299;3242;3234;3159;2122;2068;2057;1985;1177;1174;1177;1174;928;950;983;1005;
0609035;"Bychawa - obszar wiejski (5)";6926;6896;6889;6881;1364;1322;1306;1288;4207;4214;4222;4229;2712;2710;2713;2726;1495;1504;1509;1503;1355;1360;1361;1364;
0609042;"Garbów (2)";8940;8917;8953;8980;1810;1742;1730;1734;5690;5710;5719;5720;3663;3656;3667;3675;2027;2054;2052;2045;1440;1465;1504;1526;
0609052;"Głusk (2)";9388;9633;9880;10150;2112;2175;2210;2268;6041;6142;6282;6417;4033;4093;4173;4221;2008;2049;2109;2196;1235;1316;1388;1465;
0609062;"Jabłonna (2)";7919;7936;7958;7953;1592;1570;1574;1539;4906;4924;4927;4950;3139;3197;3224;3256;1767;1727;1703;1694;1421;1442;1457;1464;
0609072;"Jastków (2)";13350;13479;13559;13650;2849;2834;2754;2750;8554;8612;8696;8684;5457;5500;5542;5508;3097;3112;3154;3176;1947;2033;2109;2216;
0609082;"Konopnica (2)";12589;12790;13016;13261;2593;2606;2620;2632;7954;8097;8229;8343;5002;5089;5178;5244;2952;3008;3051;3099;2042;2087;2167;2286;
0609092;"Krzczonów (2)";4710;4650;4605;4541;806;781;771;749;2766;2731;2710;2680;1685;1671;1659;1659;1081;1060;1051;1021;1138;1138;1124;1112;
0609102;"Niedrzwica Duża (2)";11532;11631;11682;11706;2573;2553;2540;2511;7144;7223;7276;7278;4728;4767;4803;4803;2416;2456;2473;2475;1815;1855;1866;1917;
0609112;"Niemce (2)";18088;18335;18558;18781;3887;3897;3908;3932;11626;11772;11872;11952;7615;7679;7680;7686;4011;4093;4192;4266;2575;2666;2778;2897;
0609122;"Strzyżewice (2)";7884;7936;7954;7985;1625;1681;1655;1597;4963;4931;4934;4984;3160;3146;3168;3216;1803;1785;1766;1768;1296;1324;1365;1404;
0609132;"Wojciechów (2)";5947;5946;5974;5958;1171;1154;1154;1155;3651;3638;3660;3638;2318;2306;2317;2293;1333;1332;1343;1345;1125;1154;1160;1165;
0609142;"Wólka (2)";10862;11127;11309;11563;2567;2606;2606;2657;6918;7100;7217;7359;4826;4971;5034;5079;2092;2129;2183;2280;1377;1421;1486;1547;
0609152;"Wysokie (2)";4739;4702;4672;4623;832;808;768;732;2677;2675;2668;2655;1615;1639;1641;1627;1062;1036;1027;1028;1230;1219;1236;1236;
0609162;"Zakrzew (2)";3020;2980;2945;2926;501;453;436;428;1752;1760;1763;1760;1056;1071;1076;1087;696;689;687;673;767;767;746;738;
0610012;"Cyców (2)";7875;7953;7937;7931;1783;1774;1752;1729;4907;4954;4933;4920;3263;3321;3280;3270;1644;1633;1653;1650;1185;1225;1252;1282;
0610022;"Ludwin (2)";5276;5315;5394;5443;1155;1139;1149;1143;3311;3342;3385;3423;2191;2232;2271;2273;1120;1110;1114;1150;810;834;860;877;
0610033;"Łęczna (3)";24323;24027;23833;23623;4431;4323;4252;4204;17638;17260;16917;16540;10701;10447;10274;10077;6937;6813;6643;6463;2254;2444;2664;2879;
0610034;"Łęczna - miasto (4)";20317;19926;19690;19437;3645;3514;3429;3384;15048;14615;14255;13855;9019;8721;8531;8334;6029;5894;5724;5521;1624;1797;2006;2198;
0610035;"Łęczna - obszar wiejski (5)";4006;4101;4143;4186;786;809;823;820;2590;2645;2662;2685;1682;1726;1743;1743;908;919;919;942;630;647;658;681;
0610042;"Milejów (2)";9376;9327;9328;9263;1824;1755;1731;1689;5806;5807;5792;5726;3643;3659;3670;3624;2163;2148;2122;2102;1746;1765;1805;1848;
0610052;"Puchaczów (2)";5334;5377;5444;5513;1186;1169;1195;1182;3309;3354;3365;3422;2145;2188;2216;2250;1164;1166;1149;1172;839;854;884;909;
0610062;"Spiczyn (2)";5552;5588;5608;5628;1150;1160;1150;1147;3491;3495;3528;3519;2304;2315;2331;2317;1187;1180;1197;1202;911;933;930;962;
0611011;"Łuków (1)";30827;30757;30557;30477;6061;6074;5994;5925;19699;19310;18892;18579;12561;12406;12187;12057;7138;6904;6705;6522;5067;5373;5671;5973;
0611021;"Stoczek Łukowski (1)";2727;2700;2665;2631;539;521;495;483;1705;1672;1638;1590;1055;1042;1017;993;650;630;621;597;483;507;532;558;
0611032;"Adamów (2)";5843;5824;5797;5811;1249;1220;1196;1194;3566;3555;3543;3555;2370;2361;2350;2348;1196;1194;1193;1207;1028;1049;1058;1062;
0611042;"Krzywda (2)";10709;10714;10710;10640;2596;2569;2503;2457;6469;6482;6522;6468;4360;4360;4388;4333;2109;2122;2134;2135;1644;1663;1685;1715;
0611052;"Łuków (2)";17606;17606;17751;17825;4281;4174;4177;4169;10958;11039;11133;11175;7364;7416;7448;7492;3594;3623;3685;3683;2367;2393;2441;2481;
0611062;"Serokomla (2)";4185;4134;4094;4056;860;820;801;790;2501;2501;2494;2471;1622;1622;1609;1593;879;879;885;878;824;813;799;795;
0611072;"Stanin (2)";9844;9875;9833;9820;2302;2275;2218;2193;5879;5938;5963;5973;3938;3982;3991;3992;1941;1956;1972;1981;1663;1662;1652;1654;
0611082;"Stoczek Łukowski (2)";8203;8161;8096;8042;1651;1600;1584;1553;4883;4921;4895;4873;3177;3192;3164;3134;1706;1729;1731;1739;1669;1640;1617;1616;
0611092;"Trzebieszów (2)";7552;7531;7478;7457;1729;1661;1624;1591;4543;4583;4572;4576;2952;2988;2964;2962;1591;1595;1608;1614;1280;1287;1282;1290;
0611102;"Wojcieszków (2)";7097;7083;7050;7023;1575;1533;1504;1500;4244;4254;4243;4211;2815;2845;2843;2805;1429;1409;1400;1406;1278;1296;1303;1312;
0611112;"Wola Mysłowska (2)";4962;4940;4880;4815;1020;996;976;950;2935;2928;2897;2867;1833;1836;1814;1792;1102;1092;1083;1075;1007;1016;1007;998;
0612012;"Chodel (2)";6857;6801;6787;6717;1518;1473;1447;1408;4122;4102;4095;4052;2718;2710;2713;2684;1404;1392;1382;1368;1217;1226;1245;1257;
0612022;"Józefów nad Wisłą (2)";6912;6860;6816;6743;1275;1210;1186;1172;4203;4204;4163;4093;2556;2599;2580;2547;1647;1605;1583;1546;1434;1446;1467;1478;
0612032;"Karczmiska (2)";5787;5764;5745;5684;1040;991;981;952;3629;3640;3607;3578;2279;2313;2299;2267;1350;1327;1308;1311;1118;1133;1157;1154;
0612042;"Łaziska (2)";5124;5074;5065;4996;983;915;894;886;3158;3175;3173;3122;1930;1978;1997;1949;1228;1197;1176;1173;983;984;998;988;
0612053;"Opole Lubelskie (3)";17884;17814;17719;17633;3330;3239;3169;3121;11270;11217;11101;11032;7029;7030;6985;6954;4241;4187;4116;4078;3284;3358;3449;3480;
0612054;"Opole Lubelskie - miasto (4)";8901;8860;8792;8734;1523;1459;1414;1391;5744;5706;5619;5536;3532;3511;3466;3429;2212;2195;2153;2107;1634;1695;1759;1807;
0612055;"Opole Lubelskie - obszar wiejski (5)";8983;8954;8927;8899;1807;1780;1755;1730;5526;5511;5482;5496;3497;3519;3519;3525;2029;1992;1963;1971;1650;1663;1690;1673;
0612063;"Poniatowa (3)";14963;14832;14752;14630;2616;2522;2471;2425;9616;9459;9291;9082;5893;5828;5779;5673;3723;3631;3512;3409;2731;2851;2990;3123;
0612064;"Poniatowa - miasto (4)";9776;9646;9553;9495;1630;1560;1516;1499;6360;6202;6032;5870;3824;3753;3692;3596;2536;2449;2340;2274;1786;1884;2005;2126;
0612065;"Poniatowa - obszar wiejski (5)";5187;5186;5199;5135;986;962;955;926;3256;3257;3259;3212;2069;2075;2087;2077;1187;1182;1172;1135;945;967;985;997;
0612072;"Wilków (2)";4717;4658;4658;4561;866;810;803;790;2868;2871;2879;2798;1821;1814;1826;1766;1047;1057;1053;1032;983;977;976;973;
0613012;"Dębowa Kłoda (2)";4009;3997;3968;3958;801;780;764;752;2457;2465;2437;2422;1581;1585;1578;1557;876;880;859;865;751;752;767;784;
0613022;"Jabłoń (2)";3947;3918;3928;3933;734;743;742;733;2431;2377;2394;2406;1520;1479;1487;1504;911;898;907;902;782;798;792;794;
0613032;"Milanów (2)";4052;4036;4016;3960;834;822;812;801;2459;2442;2438;2400;1613;1591;1569;1535;846;851;869;865;759;772;766;759;
0613043;"Parczew (3)";14860;14867;14812;14749;2703;2706;2677;2627;9494;9413;9324;9219;5913;5855;5798;5751;3581;3558;3526;3468;2663;2748;2811;2903;
0613044;"Parczew - miasto (4)";10951;10953;10913;10863;1983;1981;1957;1922;7042;6960;6866;6763;4358;4310;4257;4211;2684;2650;2609;2552;1926;2012;2090;2178;
0613045;"Parczew - obszar wiejski (5)";3909;3914;3899;3886;720;725;720;705;2452;2453;2458;2456;1555;1545;1541;1540;897;908;917;916;737;736;721;725;
0613052;"Podedwórze (2)";1749;1735;1706;1684;286;280;274;252;1061;1044;1025;1026;598;595;589;588;463;449;436;438;402;411;407;406;
0613062;"Siemień (2)";4802;4772;4712;4680;873;835;810;803;2892;2893;2890;2870;1803;1810;1799;1802;1089;1083;1091;1068;1037;1044;1012;1007;
0613072;"Sosnowica (2)";2728;2719;2668;2664;481;453;438;444;1700;1714;1675;1654;1042;1061;1031;1041;658;653;644;613;547;552;555;566;
0614011;"Puławy (1)";49456;49100;48864;48650;8337;8273;8193;8085;29842;29246;28743;28350;18156;17740;17340;17135;11686;11506;11403;11215;11277;11581;11928;12215;
0614022;"Baranów (2)";4093;4061;4032;3999;727;711;693;669;2471;2441;2442;2426;1552;1533;1535;1539;919;908;907;887;895;909;897;904;
0614032;"Janowiec (2)";3674;3656;3664;3675;699;673;670;671;2338;2322;2314;2307;1446;1443;1458;1457;892;879;856;850;637;661;680;697;
0614043;"Kazimierz Dolny (3)";6946;6919;6902;6882;1233;1188;1174;1152;4255;4253;4232;4194;2610;2616;2600;2564;1645;1637;1632;1630;1458;1478;1496;1536;
0614044;"Kazimierz Dolny - miasto (4)";2638;2607;2599;2610;454;431;432;441;1607;1604;1591;1577;938;942;933;918;669;662;658;659;577;572;576;592;
0614045;"Kazimierz Dolny - obszar wiejski (5)";4308;4312;4303;4272;779;757;742;711;2648;2649;2641;2617;1672;1674;1667;1646;976;975;974;971;881;906;920;944;
0614052;"Końskowola (2)";9029;9016;9013;8955;1658;1626;1593;1557;5582;5581;5574;5534;3415;3402;3404;3371;2167;2179;2170;2163;1789;1809;1846;1864;
0614062;"Kurów (2)";7853;7840;7824;7766;1440;1443;1449;1409;5000;4965;4925;4887;3048;3052;3017;2993;1952;1913;1908;1894;1413;1432;1450;1470;
0614072;"Markuszów (2)";3078;3061;3048;3005;594;578;559;547;1887;1881;1874;1842;1179;1165;1176;1163;708;716;698;679;597;602;615;616;
0614083;"Nałęczów (3)";9198;9277;9140;9024;1704;1746;1685;1614;5638;5615;5492;5418;3427;3442;3339;3260;2211;2173;2153;2158;1856;1916;1963;1992;
0614084;"Nałęczów - miasto (4)";3958;4033;3892;3792;655;716;667;624;2379;2354;2236;2162;1376;1380;1279;1228;1003;974;957;934;924;963;989;1006;
0614085;"Nałęczów - obszar wiejski (5)";5240;5244;5248;5232;1049;1030;1018;990;3259;3261;3256;3256;2051;2062;2060;2032;1208;1199;1196;1224;932;953;974;986;
0614092;"Puławy (2)";11776;11879;11934;11913;2213;2212;2170;2113;7381;7441;7473;7460;4568;4586;4578;4539;2813;2855;2895;2921;2182;2226;2291;2340;
0614102;"Wąwolnica (2)";4853;4827;4820;4799;925;905;870;840;3004;2966;2977;2957;1842;1843;1867;1858;1162;1123;1110;1099;924;956;973;1002;
0614112;"Żyrzyn (2)";6570;6570;6536;6538;1269;1252;1221;1191;4067;4061;4046;4057;2601;2585;2550;2554;1466;1476;1496;1503;1234;1257;1269;1290;
0615011;"Radzyń Podlaski (1)";16298;16188;16102;16010;3180;3114;3093;2979;10549;10348;10150;10035;6389;6309;6220;6215;4160;4039;3930;3820;2569;2726;2859;2996;
0615022;"Borki (2)";6152;6117;6081;6056;1356;1318;1294;1263;3739;3745;3752;3727;2477;2484;2455;2446;1262;1261;1297;1281;1057;1054;1035;1066;
0615032;"Czemierniki (2)";4534;4522;4497;4470;908;871;849;842;2740;2751;2737;2718;1730;1742;1742;1716;1010;1009;995;1002;886;900;911;910;
0615042;"Kąkolewnica (2)";8456;8372;8297;8269;1888;1797;1757;1733;5115;5105;5073;5083;3392;3390;3353;3320;1723;1715;1720;1763;1453;1470;1467;1453;
0615052;"Komarówka Podlaska (2)";4535;4493;4446;4395;862;831;807;791;2674;2666;2645;2611;1659;1647;1625;1590;1015;1019;1020;1021;999;996;994;993;
0615062;"Radzyń Podlaski (2)";8031;8049;8088;8107;1709;1666;1645;1628;4989;5046;5058;5069;3222;3288;3296;3297;1767;1758;1762;1772;1333;1337;1385;1410;
0615072;"Ulan-Majorat (2)";6148;6126;6125;6086;1385;1342;1299;1290;3745;3771;3814;3792;2457;2461;2485;2460;1288;1310;1329;1332;1018;1013;1012;1004;
0615082;"Wohyń (2)";7041;7003;6970;6894;1387;1343;1320;1295;4258;4256;4209;4167;2644;2651;2619;2608;1614;1605;1590;1559;1396;1404;1441;1432;
0616011;"Dęblin (1)";17267;17057;16893;16722;2856;2838;2769;2733;11291;10953;10737;10510;6934;6730;6606;6470;4357;4223;4131;4040;3120;3266;3387;3479;
0616022;"Kłoczew (2)";7439;7401;7366;7308;1604;1571;1556;1526;4453;4438;4410;4387;2907;2908;2887;2890;1546;1530;1523;1497;1382;1392;1400;1395;
0616032;"Nowodwór (2)";4208;4212;4226;4205;900;884;893;883;2628;2634;2628;2603;1710;1706;1701;1685;918;928;927;918;680;694;705;719;
0616043;"Ryki (3)";20808;20788;20705;20655;4005;3916;3870;3792;13149;13101;12926;12823;8194;8201;8098;8062;4955;4900;4828;4761;3654;3771;3909;4040;
0616044;"Ryki - miasto (4)";9989;9955;9877;9886;1755;1708;1691;1680;6430;6326;6164;6069;3891;3873;3773;3734;2539;2453;2391;2335;1804;1921;2022;2137;
0616045;"Ryki - obszar wiejski (5)";10819;10833;10828;10769;2250;2208;2179;2112;6719;6775;6762;6754;4303;4328;4325;4328;2416;2447;2437;2426;1850;1850;1887;1903;
0616052;"Stężyca (2)";5303;5334;5289;5261;943;932;911;884;3271;3299;3237;3218;1949;1989;1971;1970;1322;1310;1266;1248;1089;1103;1141;1159;
0616062;"Ułęż (2)";3299;3288;3245;3237;584;604;568;559;2065;2024;2004;1999;1242;1216;1212;1219;823;808;792;780;650;660;673;679;
0617011;"Świdnik (1)";40373;40225;40078;40040;6559;6531;6480;6497;25832;25415;24926;24488;15854;15629;15379;15173;9978;9786;9547;9315;7982;8279;8672;9055;
0617022;"Mełgiew (2)";9192;9323;9350;9448;1942;1962;1939;1927;5745;5799;5829;5887;3696;3727;3720;3772;2049;2072;2109;2115;1505;1562;1582;1634;
0617033;"Piaski (3)";10681;10658;10640;10563;1953;1916;1879;1833;6559;6523;6523;6469;4175;4154;4148;4082;2384;2369;2375;2387;2169;2219;2238;2261;
0617034;"Piaski - miasto (4)";2681;2672;2657;2629;476;468;450;431;1656;1627;1614;1594;1054;1043;1035;1003;602;584;579;591;549;577;593;604;
0617035;"Piaski - obszar wiejski (5)";8000;7986;7983;7934;1477;1448;1429;1402;4903;4896;4909;4875;3121;3111;3113;3079;1782;1785;1796;1796;1620;1642;1645;1657;
0617042;"Rybczewice (2)";3606;3604;3580;3536;597;574;568;539;2145;2152;2134;2106;1265;1287;1282;1270;880;865;852;836;864;878;878;891;
0617052;"Trawniki (2)";9195;9150;9102;9055;1830;1814;1754;1713;5733;5676;5634;5603;3740;3703;3685;3658;1993;1973;1949;1945;1632;1660;1714;1739;
0618011;"Tomaszów Lubelski (1)";20209;19983;19824;19605;3531;3466;3383;3266;13159;12845;12581;12279;7905;7670;7519;7360;5254;5175;5062;4919;3519;3672;3860;4060;
0618022;"Bełżec (2)";3436;3435;3415;3390;703;674;661;632;2186;2181;2155;2151;1394;1410;1409;1395;792;771;746;756;547;580;599;607;
0618032;"Jarczów (2)";3637;3642;3594;3554;658;657;638;615;2151;2157;2133;2127;1358;1368;1349;1355;793;789;784;772;828;828;823;812;
0618042;"Krynice (2)";3426;3405;3365;3360;619;610;596;566;2043;2021;2005;2020;1261;1252;1229;1255;782;769;776;765;764;774;764;774;
0618052;"Lubycza Królewska (2)";6576;6487;6418;6444;1290;1221;1181;1166;4249;4218;4161;4163;2692;2675;2635;2633;1557;1543;1526;1530;1037;1048;1076;1115;
0618063;"Łaszczów (3)";6492;6406;6348;6293;1152;1080;1044;1002;3970;3939;3904;3857;2440;2429;2434;2425;1530;1510;1470;1432;1370;1387;1400;1434;
0618064;"Łaszczów - miasto (4)";2203;2187;2222;2202;395;377;380;378;1404;1396;1409;1381;854;845;882;863;550;551;527;518;404;414;433;443;
0618065;"Łaszczów - obszar wiejski (5)";4289;4219;4126;4091;757;703;664;624;2566;2543;2495;2476;1586;1584;1552;1562;980;959;943;914;966;973;967;991;
0618072;"Rachanie (2)";5412;5376;5349;5318;946;924;909;883;3336;3322;3302;3267;2025;2033;2029;2016;1311;1289;1273;1251;1130;1130;1138;1168;
0618082;"Susiec (2)";7745;7741;7702;7622;1434;1407;1379;1309;4811;4824;4814;4791;3062;3087;3057;3044;1749;1737;1757;1747;1500;1510;1509;1522;
0618092;"Tarnawatka (2)";4043;4031;4022;3955;827;795;771;737;2494;2515;2531;2502;1604;1624;1622;1609;890;891;909;893;722;721;720;716;
0618102;"Telatyn (2)";4300;4252;4197;4152;777;695;673;637;2624;2644;2601;2559;1606;1655;1621;1616;1018;989;980;943;899;913;923;956;
0618112;"Tomaszów Lubelski (2)";11206;11285;11363;11367;2294;2285;2240;2196;7038;7083;7161;7195;4522;4547;4578;4587;2516;2536;2583;2608;1874;1917;1962;1976;
0618123;"Tyszowce (3)";5974;5910;5859;5754;1154;1107;1087;1025;3599;3578;3521;3467;2228;2223;2197;2182;1371;1355;1324;1285;1221;1225;1251;1262;
0618124;"Tyszowce - miasto (4)";2200;2171;2170;2124;443;419;407;384;1379;1381;1370;1359;857;850;845;837;522;531;525;522;378;371;393;381;
0618125;"Tyszowce - obszar wiejski (5)";3774;3739;3689;3630;711;688;680;641;2220;2197;2151;2108;1371;1373;1352;1345;849;824;799;763;843;854;858;881;
0618132;"Ulhówek (2)";5023;4983;4929;4891;866;799;761;754;3213;3230;3183;3150;2033;2052;2039;2002;1180;1178;1144;1148;944;954;985;987;
0619011;"Włodawa (1)";13719;13643;13601;13562;2404;2415;2400;2351;9035;8783;8605;8434;5523;5412;5326;5274;3512;3371;3279;3160;2280;2445;2596;2777;
0619022;"Hanna (2)";3074;3047;3049;3009;533;512;515;504;1888;1884;1895;1850;1150;1149;1155;1148;738;735;740;702;653;651;639;655;
0619032;"Hańsk (2)";3843;3830;3789;3802;806;796;768;766;2449;2450;2408;2401;1511;1520;1517;1510;938;930;891;891;588;584;613;635;
0619042;"Stary Brus (2)";2167;2149;2122;2119;411;386;370;375;1340;1342;1327;1312;821;826;818;806;519;516;509;506;416;421;425;432;
0619052;"Urszulin (2)";4123;4112;4125;4119;818;769;772;765;2537;2560;2551;2550;1604;1630;1626;1626;933;930;925;924;768;783;802;804;
0619062;"Włodawa (2)";6045;6040;6050;6053;1155;1144;1120;1118;3860;3835;3858;3852;2438;2422;2427;2410;1422;1413;1431;1442;1030;1061;1072;1083;
0619072;"Wola Uhruska (2)";4048;4017;4018;3974;661;645;636;634;2568;2538;2530;2493;1581;1570;1560;1529;987;968;970;964;819;834;852;847;
0619082;"Wyryki (2)";2735;2729;2703;2642;521;506;489;468;1706;1712;1693;1638;1050;1051;1048;1021;656;661;645;617;508;511;521;536;
0620012;"Adamów (2)";4895;4871;4831;4796;975;951;917;866;2947;2943;2937;2936;1911;1909;1902;1910;1036;1034;1035;1026;973;977;977;994;
0620022;"Grabowiec (2)";4343;4289;4229;4200;753;706;690;664;2533;2513;2481;2470;1538;1527;1498;1492;995;986;983;978;1057;1070;1058;1066;
0620032;"Komarów-Osada (2)";5336;5323;5286;5221;987;972;963;935;3200;3197;3165;3136;2033;2047;2036;2032;1167;1150;1129;1104;1149;1154;1158;1150;
0620043;"Krasnobród (3)";7219;7243;7255;7207;1463;1423;1391;1340;4405;4441;4458;4454;2834;2826;2826;2785;1571;1615;1632;1669;1351;1379;1406;1413;
0620044;"Krasnobród - miasto (4)";3097;3117;3108;3117;598;590;570;564;1973;1978;1976;1975;1245;1240;1230;1218;728;738;746;757;526;549;562;578;
0620045;"Krasnobród - obszar wiejski (5)";4122;4126;4147;4090;865;833;821;776;2432;2463;2482;2479;1589;1586;1596;1567;843;877;886;912;825;830;844;835;
0620052;"Łabunie (2)";6320;6295;6299;6271;1307;1266;1232;1187;3973;3984;3995;3994;2563;2561;2560;2560;1410;1423;1435;1434;1040;1045;1072;1090;
0620062;"Miączyn (2)";6143;6082;6019;5992;1231;1152;1097;1067;3706;3699;3688;3694;2404;2400;2378;2379;1302;1299;1310;1315;1206;1231;1234;1231;
0620072;"Nielisz (2)";5769;5723;5690;5648;1017;970;927;896;3416;3420;3412;3409;2113;2129;2126;2116;1303;1291;1286;1293;1336;1333;1351;1343;
0620082;"Radecznica (2)";6055;6005;5969;5957;929;881;853;851;3571;3570;3542;3536;2082;2082;2067;2077;1489;1488;1475;1459;1555;1554;1574;1570;
0620092;"Sitno (2)";6861;6855;6801;6812;1322;1295;1257;1259;4432;4435;4387;4362;2846;2848;2817;2796;1586;1587;1570;1566;1107;1125;1157;1191;
0620102;"Skierbieszów (2)";5423;5367;5325;5302;992;954;920;915;3150;3146;3158;3138;2001;2003;2009;1998;1149;1143;1149;1140;1281;1267;1247;1249;
0620112;"Stary Zamość (2)";5370;5322;5325;5276;1009;973;967;923;3262;3248;3233;3222;2044;2053;2042;2029;1218;1195;1191;1193;1099;1101;1125;1131;
0620122;"Sułów (2)";4829;4765;4699;4645;855;791;771;736;2847;2861;2820;2789;1761;1771;1735;1733;1086;1090;1085;1056;1127;1113;1108;1120;
0620133;"Szczebrzeszyn (3)";11761;11686;11618;11509;2109;2069;2002;1934;7403;7349;7303;7228;4569;4549;4514;4443;2834;2800;2789;2785;2249;2268;2313;2347;
0620134;"Szczebrzeszyn - miasto (4)";5276;5245;5202;5151;900;901;874;863;3432;3381;3350;3289;2067;2055;2045;1985;1365;1326;1305;1304;944;963;978;999;
0620135;"Szczebrzeszyn - obszar wiejski (5)";6485;6441;6416;6358;1209;1168;1128;1071;3971;3968;3953;3939;2502;2494;2469;2458;1469;1474;1484;1481;1305;1305;1335;1348;
0620142;"Zamość (2)";22125;22305;22414;22595;4516;4485;4421;4309;14260;14393;14476;14645;9028;9097;9089;9155;5232;5296;5387;5490;3349;3427;3517;3641;
0620153;"Zwierzyniec (3)";7073;7067;7017;6962;1275;1273;1247;1197;4369;4350;4301;4275;2647;2627;2585;2571;1722;1723;1716;1704;1429;1444;1469;1490;
0620154;"Zwierzyniec - miasto (4)";3342;3347;3321;3282;581;597;581;541;2107;2077;2065;2052;1258;1243;1227;1221;849;834;838;831;654;673;675;689;
0620155;"Zwierzyniec - obszar wiejski (5)";3731;3720;3696;3680;694;676;666;656;2262;2273;2236;2223;1389;1384;1358;1350;873;889;878;873;775;771;794;801;
0661011;"Biała Podlaska (1)";57990;57658;57471;57414;10619;10512;10392;10265;38773;38061;37515;37000;24125;23709;23383;23218;14648;14352;14132;13782;8598;9085;9564;10149;
0662011;"Chełm (1)";65897;65481;64855;64270;10667;10472;10197;9986;43398;42655;41751;40766;26240;25928;25393;24841;17158;16727;16358;15925;11832;12354;12907;13518;
0663011;"Lublin (1)";347678;343598;341722;340727;56314;56058;55895;56090;223582;217372;213308;209771;143055;138449;136105;134079;80527;78923;77203;75692;67782;70168;72519;74866;
0664011;"Zamość (1)";65612;65255;65055;64788;11302;11235;11048;10826;43260;42409;41795;41219;26265;25786;25544;25286;16995;16623;16251;15933;11050;11611;12212;12743;
0801011;"Kostrzyn nad Odrą (1)";18125;18155;18155;18031;3641;3608;3569;3503;11641;11579;11486;11329;7245;7247;7204;7105;4396;4332;4282;4224;2843;2968;3100;3199;
0801022;"Bogdaniec (2)";7121;7120;7115;7089;1521;1498;1459;1419;4542;4516;4493;4486;2891;2892;2895;2873;1651;1624;1598;1613;1058;1106;1163;1184;
0801032;"Deszczno (2)";8867;8951;9150;9339;1902;1862;1881;1911;5873;5896;5999;6093;3758;3778;3841;3895;2115;2118;2158;2198;1092;1193;1270;1335;
0801042;"Kłodawa (2)";7879;8046;8201;8298;1685;1694;1744;1744;5320;5413;5451;5477;3269;3350;3366;3383;2051;2063;2085;2094;874;939;1006;1077;
0801052;"Lubiszyn (2)";6902;6934;6925;6894;1414;1394;1354;1329;4510;4530;4547;4500;2838;2854;2862;2790;1672;1676;1685;1710;978;1010;1024;1065;
0801062;"Santok (2)";8019;8072;8157;8216;1612;1621;1632;1625;5384;5374;5390;5391;3374;3385;3410;3409;2010;1989;1980;1982;1023;1077;1135;1200;
0801073;"Witnica (3)";13097;13098;13088;13062;2637;2585;2551;2498;8590;8569;8521;8499;5390;5382;5357;5361;3200;3187;3164;3138;1870;1944;2016;2065;
0801074;"Witnica - miasto (4)";7000;6951;6923;6908;1384;1338;1332;1293;4597;4538;4482;4470;2884;2843;2809;2802;1713;1695;1673;1668;1019;1075;1109;1145;
0801075;"Witnica - obszar wiejski (5)";6097;6147;6165;6154;1253;1247;1219;1205;3993;4031;4039;4029;2506;2539;2548;2559;1487;1492;1491;1470;851;869;907;920;
0802011;"Gubin (1)";17019;17006;16874;16815;3028;2963;2904;2870;11131;11043;10869;10750;6815;6824;6740;6674;4316;4219;4129;4076;2860;3000;3101;3195;
0802022;"Bobrowice (2)";3215;3174;3190;3203;622;588;579;566;2072;2051;2046;2039;1253;1247;1257;1283;819;804;789;756;521;535;565;598;
0802032;"Bytnica (2)";2618;2588;2572;2542;513;491;475;476;1714;1699;1667;1620;1055;1055;1044;1019;659;644;623;601;391;398;430;446;
0802042;"Dąbie (2)";5067;5053;5044;5045;1020;999;984;964;3400;3372;3350;3342;2057;2058;2057;2069;1343;1314;1293;1273;647;682;710;739;
0802052;"Gubin (2)";7374;7355;7343;7299;1467;1455;1407;1360;4926;4877;4860;4825;3117;3102;3113;3079;1809;1775;1747;1746;981;1023;1076;1114;
0802063;"Krosno Odrzańskie (3)";18536;18523;18293;18157;3329;3293;3199;3163;12221;12060;11758;11496;7489;7494;7364;7235;4732;4566;4394;4261;2986;3170;3336;3498;
0802064;"Krosno Odrzańskie - miasto (4)";12038;11983;11799;11637;2090;2075;2030;1964;7907;7729;7454;7220;4840;4785;4678;4556;3067;2944;2776;2664;2041;2179;2315;2453;
0802065;"Krosno Odrzańskie - obszar wiejski (5)";6498;6540;6494;6520;1239;1218;1169;1199;4314;4331;4304;4276;2649;2709;2686;2679;1665;1622;1618;1597;945;991;1021;1045;
0802072;"Maszewo (2)";2922;2928;2919;2882;589;558;554;533;1865;1894;1863;1832;1128;1161;1139;1120;737;733;724;712;468;476;502;517;
0803012;"Bledzew (2)";4573;4543;4495;4465;860;849;825;828;2989;2962;2903;2845;1870;1844;1812;1770;1119;1118;1091;1075;724;732;767;792;
0803023;"Międzyrzecz (3)";25175;25155;25131;25113;4514;4462;4457;4457;16378;16259;16051;15889;10161;10142;10070;10009;6217;6117;5981;5880;4283;4434;4623;4767;
0803024;"Międzyrzecz - miasto (4)";18610;18552;18459;18392;3239;3230;3206;3199;12058;11887;11662;11503;7429;7363;7272;7214;4629;4524;4390;4289;3313;3435;3591;3690;
0803025;"Międzyrzecz - obszar wiejski (5)";6565;6603;6672;6721;1275;1232;1251;1258;4320;4372;4389;4386;2732;2779;2798;2795;1588;1593;1591;1591;970;999;1032;1077;
0803032;"Przytoczna (2)";5719;5694;5729;5742;1027;991;997;1013;3823;3801;3773;3726;2290;2287;2297;2275;1533;1514;1476;1451;869;902;959;1003;
0803042;"Pszczew (2)";4223;4269;4303;4267;805;787;777;764;2752;2786;2798;2740;1738;1771;1773;1738;1014;1015;1025;1002;666;696;728;763;
0803053;"Skwierzyna (3)";12601;12477;12404;12372;2314;2205;2151;2116;8353;8217;8107;8004;5046;4970;4926;4913;3307;3247;3181;3091;1934;2055;2146;2252;
0803054;"Skwierzyna - miasto (4)";9941;9869;9805;9797;1822;1761;1720;1686;6606;6498;6398;6327;3965;3912;3867;3871;2641;2586;2531;2456;1513;1610;1687;1784;
0803055;"Skwierzyna - obszar wiejski (5)";2660;2608;2599;2575;492;444;431;430;1747;1719;1709;1677;1081;1058;1059;1042;666;661;650;635;421;445;459;468;
0803063;"Trzciel (3)";6558;6559;6578;6537;1294;1250;1242;1202;4221;4233;4224;4197;2612;2639;2656;2669;1609;1594;1568;1528;1043;1076;1112;1138;
0803064;"Trzciel - miasto (4)";2476;2496;2501;2475;468;468;478;466;1586;1593;1569;1551;977;997;995;1003;609;596;574;548;422;435;454;458;
0803065;"Trzciel - obszar wiejski (5)";4082;4063;4077;4062;826;782;764;736;2635;2640;2655;2646;1635;1642;1661;1666;1000;998;994;980;621;641;658;680;
0804011;"Nowa Sól (1)";40022;39721;39571;39512;6975;6827;6764;6747;25367;24863;24432;24049;15185;15050;14964;14864;10182;9813;9468;9185;7680;8031;8375;8716;
0804023;"Bytom Odrzański (3)";5555;5524;5503;5490;1131;1107;1079;1065;3597;3565;3542;3484;2297;2296;2292;2265;1300;1269;1250;1219;827;852;882;941;
0804024;"Bytom Odrzański - miasto (4)";4479;4443;4420;4387;889;869;846;825;2907;2868;2851;2791;1839;1830;1814;1788;1068;1038;1037;1003;683;706;723;771;
0804025;"Bytom Odrzański - obszar wiejski (5)";1076;1081;1083;1103;242;238;233;240;690;697;691;693;458;466;478;477;232;231;213;216;144;146;159;170;
0804032;"Kolsko (2)";3306;3310;3343;3346;681;670;674;666;2131;2115;2103;2077;1315;1313;1304;1294;816;802;799;783;494;525;566;603;
0804043;"Kożuchów (3)";16325;16312;16245;16158;3223;3200;3127;3036;10321;10199;10090;10003;6434;6425;6354;6347;3887;3774;3736;3656;2781;2913;3028;3119;
0804044;"Kożuchów - miasto (4)";9718;9752;9711;9604;1832;1847;1798;1739;6070;5995;5925;5824;3772;3782;3748;3717;2298;2213;2177;2107;1816;1910;1988;2041;
0804045;"Kożuchów - obszar wiejski (5)";6607;6560;6534;6554;1391;1353;1329;1297;4251;4204;4165;4179;2662;2643;2606;2630;1589;1561;1559;1549;965;1003;1040;1078;
0804052;"Nowa Sól (2)";6812;6829;6860;6846;1404;1390;1380;1340;4415;4382;4371;4324;2775;2774;2804;2795;1640;1608;1567;1529;993;1057;1109;1182;
0804063;"Nowe Miasteczko (3)";5552;5528;5543;5488;1132;1098;1088;1058;3538;3526;3515;3485;2194;2208;2217;2200;1344;1318;1298;1285;882;904;940;945;
0804064;"Nowe Miasteczko - miasto (4)";2879;2884;2897;2857;556;536;538;517;1810;1819;1804;1794;1111;1137;1134;1118;699;682;670;676;513;529;555;546;
0804065;"Nowe Miasteczko - obszar wiejski (5)";2673;2644;2646;2631;576;562;550;541;1728;1707;1711;1691;1083;1071;1083;1082;645;636;628;609;369;375;385;399;
0804072;"Otyń (2)";6735;6829;6824;6892;1465;1446;1410;1392;4382;4448;4417;4447;2839;2907;2885;2911;1543;1541;1532;1536;888;935;997;1053;
0804082;"Siedlisko (2)";3677;3674;3635;3607;846;829;798;778;2371;2376;2331;2297;1548;1535;1514;1489;823;841;817;808;460;469;506;532;
0805013;"Cybinka (3)";6725;6656;6636;6606;1393;1321;1289;1255;4306;4288;4291;4237;2674;2670;2688;2644;1632;1618;1603;1593;1026;1047;1056;1114;
0805014;"Cybinka - miasto (4)";2834;2809;2778;2791;556;532;514;505;1825;1813;1791;1786;1145;1143;1123;1127;680;670;668;659;453;464;473;500;
0805015;"Cybinka - obszar wiejski (5)";3891;3847;3858;3815;837;789;775;750;2481;2475;2500;2451;1529;1527;1565;1517;952;948;935;934;573;583;583;614;
0805022;"Górzyca (2)";4258;4267;4282;4264;924;903;902;884;2775;2794;2793;2773;1795;1813;1807;1785;980;981;986;988;559;570;587;607;
0805033;"Ośno Lubuskie (3)";6488;6505;6437;6432;1309;1282;1245;1225;4281;4296;4237;4203;2663;2675;2621;2619;1618;1621;1616;1584;898;927;955;1004;
0805034;"Ośno Lubuskie - miasto (4)";3880;3889;3856;3880;757;737;721;719;2571;2580;2542;2538;1581;1594;1558;1577;990;986;984;961;552;572;593;623;
0805035;"Ośno Lubuskie - obszar wiejski (5)";2608;2616;2581;2552;552;545;524;506;1710;1716;1695;1665;1082;1081;1063;1042;628;635;632;623;346;355;362;381;
0805043;"Rzepin (3)";9975;9988;9938;9964;2027;2060;2030;2001;6493;6418;6326;6313;4072;4013;3972;3984;2421;2405;2354;2329;1455;1510;1582;1650;
0805044;"Rzepin - miasto (4)";6706;6689;6660;6666;1303;1289;1284;1253;4365;4318;4250;4234;2719;2695;2664;2672;1646;1623;1586;1562;1038;1082;1126;1179;
0805045;"Rzepin - obszar wiejski (5)";3269;3299;3278;3298;724;771;746;748;2128;2100;2076;2079;1353;1318;1308;1312;775;782;768;767;417;428;456;471;
0805053;"Słubice (3)";19883;19902;19985;20009;3674;3660;3623;3579;13246;13168;13149;13067;8223;8207;8200;8177;5023;4961;4949;4890;2963;3074;3213;3363;
0805054;"Słubice - miasto (4)";16902;16880;16914;16918;3013;2998;2965;2923;11250;11137;11081;10995;6991;6962;6938;6912;4259;4175;4143;4083;2639;2745;2868;3000;
0805055;"Słubice - obszar wiejski (5)";2981;3022;3071;3091;661;662;658;656;1996;2031;2068;2072;1232;1245;1262;1265;764;786;806;807;324;329;345;363;
0806013;"Dobiegniew (3)";6857;6793;6719;6688;1242;1174;1140;1121;4393;4377;4288;4209;2624;2615;2560;2544;1769;1762;1728;1665;1222;1242;1291;1358;
0806014;"Dobiegniew - miasto (4)";3204;3169;3125;3095;534;508;480;480;2077;2070;2015;1959;1244;1238;1197;1175;833;832;818;784;593;591;630;656;
0806015;"Dobiegniew - obszar wiejski (5)";3653;3624;3594;3593;708;666;660;641;2316;2307;2273;2250;1380;1377;1363;1369;936;930;910;881;629;651;661;702;
0806023;"Drezdenko (3)";17637;17579;17511;17447;3475;3419;3365;3334;11251;11135;11007;10816;7030;7008;7006;6916;4221;4127;4001;3900;2911;3025;3139;3297;
0806024;"Drezdenko - miasto (4)";10491;10447;10388;10377;1881;1846;1844;1857;6733;6636;6509;6362;4132;4122;4092;4057;2601;2514;2417;2305;1877;1965;2035;2158;
0806025;"Drezdenko - obszar wiejski (5)";7146;7132;7123;7070;1594;1573;1521;1477;4518;4499;4498;4454;2898;2886;2914;2859;1620;1613;1584;1595;1034;1060;1104;1139;
0806032;"Stare Kurowo (2)";4196;4173;4184;4147;843;816;811;787;2713;2683;2660;2626;1669;1649;1647;1646;1044;1034;1013;980;640;674;713;734;
0806043;"Strzelce Krajeńskie (3)";17495;17426;17346;17357;3429;3398;3328;3301;11310;11147;10995;10882;6894;6811;6743;6729;4416;4336;4252;4153;2756;2881;3023;3174;
0806044;"Strzelce Krajeńskie - miasto (4)";10204;10172;10118;10120;1893;1887;1860;1850;6661;6532;6421;6310;3978;3927;3877;3856;2683;2605;2544;2454;1650;1753;1837;1960;
0806045;"Strzelce Krajeńskie - obszar wiejski (5)";7291;7254;7228;7237;1536;1511;1468;1451;4649;4615;4574;4572;2916;2884;2866;2873;1733;1731;1708;1699;1106;1128;1186;1214;
0806052;"Zwierzyn (2)";4479;4447;4452;4422;960;929;919;872;2864;2854;2851;2852;1807;1802;1802;1798;1057;1052;1049;1054;655;664;682;698;
0807012;"Krzeszyce (2)";4687;4707;4741;4765;926;898;922;928;3052;3088;3082;3069;1918;1948;1944;1941;1134;1140;1138;1128;709;721;737;768;
0807023;"Lubniewice (3)";3172;3154;3181;3135;535;510;503;502;2122;2096;2098;2017;1274;1285;1278;1234;848;811;820;783;515;548;580;616;
0807024;"Lubniewice - miasto (4)";2064;2040;2076;2055;345;321;321;323;1369;1348;1352;1299;798;798;806;779;571;550;546;520;350;371;403;433;
0807025;"Lubniewice - obszar wiejski (5)";1108;1114;1105;1080;190;189;182;179;753;748;746;718;476;487;472;455;277;261;274;263;165;177;177;183;
0807032;"Słońsk (2)";4826;4803;4804;4753;999;973;962;909;3197;3178;3174;3144;2034;2025;2033;2021;1163;1153;1141;1123;630;652;668;700;
0807043;"Sulęcin (3)";16150;16131;16107;16023;3128;3097;3064;3009;10464;10322;10231;10079;6593;6552;6519;6442;3871;3770;3712;3637;2558;2712;2812;2935;
0807044;"Sulęcin - miasto (4)";10277;10265;10278;10231;1909;1905;1898;1874;6648;6524;6462;6367;4100;4062;4062;4026;2548;2462;2400;2341;1720;1836;1918;1990;
0807045;"Sulęcin - obszar wiejski (5)";5873;5866;5829;5792;1219;1192;1166;1135;3816;3798;3769;3712;2493;2490;2457;2416;1323;1308;1312;1296;838;876;894;945;
0807053;"Torzym (3)";6969;6973;6928;6920;1432;1372;1366;1361;4522;4548;4495;4468;2762;2821;2788;2779;1760;1727;1707;1689;1015;1053;1067;1091;
0807054;"Torzym - miasto (4)";2592;2597;2571;2561;494;491;496;499;1720;1712;1686;1656;1014;1019;1011;1000;706;693;675;656;378;394;389;406;
0807055;"Torzym - obszar wiejski (5)";4377;4376;4357;4359;938;881;870;862;2802;2836;2809;2812;1748;1802;1777;1779;1054;1034;1032;1033;637;659;678;685;
0808012;"Lubrza (2)";3514;3522;3512;3538;732;709;687;677;2307;2312;2307;2328;1461;1466;1462;1479;846;846;845;849;475;501;518;533;
0808022;"Łagów (2)";5190;5156;5083;5005;882;855;819;792;3425;3378;3326;3242;2125;2091;2030;2013;1300;1287;1296;1229;883;923;938;971;
0808032;"Skąpe (2)";5174;5132;5141;5167;970;925;933;930;3371;3346;3323;3342;2024;2018;2010;2010;1347;1328;1313;1332;833;861;885;895;
0808042;"Szczaniec (2)";3937;3944;3905;3916;840;817;797;777;2565;2587;2547;2542;1614;1629;1606;1588;951;958;941;954;532;540;561;597;
0808053;"Świebodzin (3)";30485;30405;30370;30282;5864;5781;5690;5656;19573;19350;19186;18930;12140;12114;12131;12023;7433;7236;7055;6907;5048;5274;5494;5696;
0808054;"Świebodzin - miasto (4)";22109;22064;22008;21963;4091;4065;3994;3991;14158;13952;13792;13596;8685;8648;8648;8563;5473;5304;5144;5033;3860;4047;4222;4376;
0808055;"Świebodzin - obszar wiejski (5)";8376;8341;8362;8319;1773;1716;1696;1665;5415;5398;5394;5334;3455;3466;3483;3460;1960;1932;1911;1874;1188;1227;1272;1320;
0808063;"Zbąszynek (3)";8366;8387;8404;8382;1660;1704;1697;1656;5396;5323;5284;5236;3397;3347;3350;3337;1999;1976;1934;1899;1310;1360;1423;1490;
0808064;"Zbąszynek - miasto (4)";5082;5078;5060;5054;989;976;949;937;3232;3199;3155;3125;2016;2018;2018;2002;1216;1181;1137;1123;861;903;956;992;
0808065;"Zbąszynek - obszar wiejski (5)";3284;3309;3344;3328;671;728;748;719;2164;2124;2129;2111;1381;1329;1332;1335;783;795;797;776;449;457;467;498;
0809013;"Babimost (3)";6326;6333;6295;6251;1247;1236;1215;1175;4026;3992;3970;3938;2562;2547;2516;2515;1464;1445;1454;1423;1053;1105;1110;1138;
0809014;"Babimost - miasto (4)";4038;4037;3999;3943;773;776;754;718;2589;2543;2529;2492;1653;1631;1606;1597;936;912;923;895;676;718;716;733;
0809015;"Babimost - obszar wiejski (5)";2288;2296;2296;2308;474;460;461;457;1437;1449;1441;1446;909;916;910;918;528;533;531;528;377;387;394;405;
0809022;"Bojadła (2)";3382;3383;3334;3318;652;634;609;601;2163;2154;2125;2110;1379;1364;1360;1370;784;790;765;740;567;595;600;607;
0809033;"Czerwieńsk (3)";9977;10021;10002;9963;2008;1990;1946;1908;6612;6559;6497;6391;4185;4201;4201;4138;2427;2358;2296;2253;1357;1472;1559;1664;
0809034;"Czerwieńsk - miasto (4)";4233;4200;4159;4115;785;765;738;722;2875;2814;2759;2689;1800;1788;1777;1732;1075;1026;982;957;573;621;662;704;
0809035;"Czerwieńsk - obszar wiejski (5)";5744;5821;5843;5848;1223;1225;1208;1186;3737;3745;3738;3702;2385;2413;2424;2406;1352;1332;1314;1296;784;851;897;960;
0809043;"Kargowa (3)";5833;5844;5860;5862;1167;1149;1161;1166;3768;3747;3716;3701;2431;2437;2428;2416;1337;1310;1288;1285;898;948;983;995;
0809044;"Kargowa - miasto (4)";3731;3743;3768;3778;747;735;747;740;2411;2405;2395;2395;1570;1567;1578;1579;841;838;817;816;573;603;626;643;
0809045;"Kargowa - obszar wiejski (5)";2102;2101;2092;2084;420;414;414;426;1357;1342;1321;1306;861;870;850;837;496;472;471;469;325;345;357;352;
0809053;"Nowogród Bobrzański (3)";9465;9476;9473;9454;1799;1782;1759;1723;6302;6254;6180;6125;4000;3992;3954;3924;2302;2262;2226;2201;1364;1440;1534;1606;
0809054;"Nowogród Bobrzański - miasto (4)";5152;5161;5151;5147;918;905;900;907;3488;3449;3371;3293;2156;2157;2118;2087;1332;1292;1253;1206;746;807;880;947;
0809055;"Nowogród Bobrzański - obszar wiejski (5)";4313;4315;4322;4307;881;877;859;816;2814;2805;2809;2832;1844;1835;1836;1837;970;970;973;995;618;633;654;659;
0809063;"Sulechów (3)";26755;26609;26495;26453;4754;4648;4617;4588;17824;17563;17306;17087;11020;10940;10847;10773;6804;6623;6459;6314;4177;4398;4572;4778;
0809064;"Sulechów - miasto (4)";17680;17461;17322;17176;2953;2874;2835;2766;11886;11586;11356;11117;7294;7164;7070;6946;4592;4422;4286;4171;2841;3001;3131;3293;
0809065;"Sulechów - obszar wiejski (5)";9075;9148;9173;9277;1801;1774;1782;1822;5938;5977;5950;5970;3726;3776;3777;3827;2212;2201;2173;2143;1336;1397;1441;1485;
0809072;"Świdnica (2)";6307;6330;6443;6467;1246;1215;1216;1207;4176;4204;4265;4245;2582;2598;2659;2656;1594;1606;1606;1589;885;911;962;1015;
0809082;"Trzebiechów (2)";3369;3372;3413;3405;681;661;672;670;2183;2196;2187;2172;1363;1376;1384;1379;820;820;803;793;505;515;554;563;
0809092;"Zabór (2)";3947;3995;4027;4046;830;828;812;787;2619;2649;2678;2687;1673;1680;1699;1717;946;969;979;970;498;518;537;572;
0809102;"Zielona Góra (2)";19200;19556;19592;;3992;4011;3936;;12838;13043;12993;;8251;8379;8316;;4587;4664;4677;;2370;2502;2663;;
0810011;"Gozdnica (1)";3328;3272;3228;3195;565;523;503;472;2145;2116;2086;2052;1287;1276;1270;1276;858;840;816;776;618;633;639;671;
0810021;"Żagań (1)";26653;26492;26426;26235;4628;4520;4494;4415;17375;17112;16854;16528;10382;10356;10317;10188;6993;6756;6537;6340;4650;4860;5078;5292;
0810032;"Brzeźnica (2)";3804;3787;3773;3774;801;769;748;727;2448;2442;2428;2427;1550;1574;1567;1568;898;868;861;859;555;576;597;620;
0810043;"Iłowa (3)";7086;7069;7009;6990;1282;1267;1240;1227;4569;4548;4490;4465;2734;2728;2692;2681;1835;1820;1798;1784;1235;1254;1279;1298;
0810044;"Iłowa - miasto (4)";4044;4013;3996;3978;715;695;674;666;2562;2551;2542;2522;1532;1530;1532;1518;1030;1021;1010;1004;767;767;780;790;
0810045;"Iłowa - obszar wiejski (5)";3042;3056;3013;3012;567;572;566;561;2007;1997;1948;1943;1202;1198;1160;1163;805;799;788;780;468;487;499;508;
0810053;"Małomice (3)";5360;5339;5329;5321;928;900;892;882;3473;3456;3432;3403;2102;2110;2121;2127;1371;1346;1311;1276;959;983;1005;1036;
0810054;"Małomice - miasto (4)";3621;3573;3571;3580;611;563;569;557;2350;2335;2310;2306;1421;1428;1430;1448;929;907;880;858;660;675;692;717;
0810055;"Małomice - obszar wiejski (5)";1739;1766;1758;1741;317;337;323;325;1123;1121;1122;1097;681;682;691;679;442;439;431;418;299;308;313;319;
0810062;"Niegosławice (2)";4598;4554;4534;4536;955;921;898;899;2914;2903;2896;2862;1812;1810;1813;1809;1102;1093;1083;1053;729;730;740;775;
0810073;"Szprotawa (3)";21823;21722;21555;21335;4170;4061;3981;3830;13937;13826;13568;13370;8620;8602;8476;8365;5317;5224;5092;5005;3716;3835;4006;4135;
0810074;"Szprotawa - miasto (4)";12445;12329;12252;12176;2153;2073;2043;1988;7896;7776;7596;7477;4756;4751;4699;4673;3140;3025;2897;2804;2396;2480;2613;2711;
0810075;"Szprotawa - obszar wiejski (5)";9378;9393;9303;9159;2017;1988;1938;1842;6041;6050;5972;5893;3864;3851;3777;3692;2177;2199;2195;2201;1320;1355;1393;1424;
0810082;"Wymiarki (2)";2394;2359;2362;2356;402;383;377;392;1612;1589;1570;1532;961;953;955;936;651;636;615;596;380;387;415;432;
0810092;"Żagań (2)";7141;7209;7246;7255;1475;1472;1466;1429;4723;4748;4731;4745;3014;3059;3060;3037;1709;1689;1671;1708;943;989;1049;1081;
0811011;"Łęknica (1)";2602;2602;2578;2531;549;530;505;482;1724;1720;1707;1670;1122;1142;1134;1106;602;578;573;564;329;352;366;379;
0811021;"Żary (1)";39066;38856;38527;38287;6931;6818;6639;6527;25151;24786;24330;23886;15318;15219;15071;14925;9833;9567;9259;8961;6984;7252;7558;7874;
0811032;"Brody (2)";3557;3508;3482;3440;749;702;668;643;2354;2328;2315;2273;1432;1429;1421;1403;922;899;894;870;454;478;499;524;
0811043;"Jasień (3)";7240;7241;7237;7169;1363;1329;1295;1258;4731;4721;4703;4636;2933;2967;2984;2968;1798;1754;1719;1668;1146;1191;1239;1275;
0811044;"Jasień - miasto (4)";4455;4463;4449;4405;798;773;750;727;2891;2889;2866;2827;1760;1794;1804;1800;1131;1095;1062;1027;766;801;833;851;
0811045;"Jasień - obszar wiejski (5)";2785;2778;2788;2764;565;556;545;531;1840;1832;1837;1809;1173;1173;1180;1168;667;659;657;641;380;390;406;424;
0811052;"Lipinki Łużyckie (2)";3326;3334;3327;3307;677;660;651;651;2144;2157;2147;2128;1345;1365;1367;1341;799;792;780;787;505;517;529;528;
0811063;"Lubsko (3)";19256;19170;19074;18968;3576;3501;3455;3363;12520;12401;12209;12018;7609;7620;7533;7498;4911;4781;4676;4520;3160;3268;3410;3587;
0811064;"Lubsko - miasto (4)";14646;14554;14451;14335;2620;2574;2538;2464;9497;9362;9176;8979;5670;5659;5556;5500;3827;3703;3620;3479;2529;2618;2737;2892;
0811065;"Lubsko - obszar wiejski (5)";4610;4616;4623;4633;956;927;917;899;3023;3039;3033;3039;1939;1961;1977;1998;1084;1078;1056;1041;631;650;673;695;
0811072;"Przewóz (2)";3258;3252;3240;3224;665;652;604;587;2128;2115;2124;2122;1298;1303;1320;1308;830;812;804;814;465;485;512;515;
0811082;"Trzebiel (2)";5785;5752;5734;5724;1150;1088;1074;1043;3719;3715;3684;3673;2350;2370;2363;2381;1369;1345;1321;1292;916;949;976;1008;
0811092;"Tuplice (2)";3259;3220;3198;3159;606;576;558;531;2105;2075;2051;2022;1288;1283;1275;1254;817;792;776;768;548;569;589;606;
0811102;"Żary (2)";12097;12153;12228;12351;2435;2426;2424;2423;8066;8047;8043;8111;5095;5107;5126;5178;2971;2940;2917;2933;1596;1680;1761;1817;
0812013;"Sława (3)";12597;12607;12625;12630;2734;2654;2627;2610;7962;7958;7909;7856;5044;5050;5027;5008;2918;2908;2882;2848;1901;1995;2089;2164;
0812014;"Sława - miasto (4)";3957;3913;4299;4307;773;738;797;776;2512;2475;2680;2667;1520;1501;1631;1648;992;974;1049;1019;672;700;822;864;
0812015;"Sława - obszar wiejski (5)";8640;8694;8326;8323;1961;1916;1830;1834;5450;5483;5229;5189;3524;3549;3396;3360;1926;1934;1833;1829;1229;1295;1267;1300;
0812023;"Szlichtyngowa (3)";5134;5139;5064;5088;1139;1124;1053;1051;3323;3311;3278;3280;2110;2106;2079;2089;1213;1205;1199;1191;672;704;733;757;
0812024;"Szlichtyngowa - miasto (4)";1337;1328;1289;1317;283;284;262;259;858;848;832;856;537;519;495;508;321;329;337;348;196;196;195;202;
0812025;"Szlichtyngowa - obszar wiejski (5)";3797;3811;3775;3771;856;840;791;792;2465;2463;2446;2424;1573;1587;1584;1581;892;876;862;843;476;508;538;555;
0812033;"Wschowa (3)";21703;21688;21676;21579;4256;4192;4132;4102;13950;13853;13767;13597;8795;8802;8812;8727;5155;5051;4955;4870;3497;3643;3777;3880;
0812034;"Wschowa - miasto (4)";14322;14313;14265;14217;2649;2613;2557;2560;9226;9132;9032;8900;5729;5715;5707;5626;3497;3417;3325;3274;2447;2568;2676;2757;
0812035;"Wschowa - obszar wiejski (5)";7381;7375;7411;7362;1607;1579;1575;1542;4724;4721;4735;4697;3066;3087;3105;3101;1658;1634;1630;1596;1050;1075;1101;1123;
0861011;"Gorzów Wielkopolski (1)";124609;124344;124145;123762;21091;21226;21140;21163;80741;79233;77919;76291;49511;48877;48481;47783;31230;30356;29438;28508;22777;23885;25086;26308;
0862011;"Zielona Góra (1)";119023;118405;118920;138711;19230;19574;19961;24013;76584;74636;73771;85614;47872;46856;46664;54575;28712;27780;27107;31039;23209;24195;25188;29084;
1001011;"Bełchatów (1)";60032;59565;59305;58667;10411;10308;10266;10166;42711;41747;40947;39787;25105;24687;24448;23886;17606;17060;16499;15901;6910;7510;8092;8714;
1001022;"Bełchatów (2)";10422;10585;10679;10857;2075;2069;2054;2119;6811;6926;6969;7041;4241;4328;4342;4399;2570;2598;2627;2642;1536;1590;1656;1697;
1001032;"Drużbice (2)";5089;5097;5135;5153;980;964;970;947;3190;3185;3206;3238;1969;1987;1993;2030;1221;1198;1213;1208;919;948;959;968;
1001042;"Kleszczów (2)";5009;5165;5351;5594;1215;1264;1312;1379;3176;3278;3406;3557;2177;2269;2363;2484;999;1009;1043;1073;618;623;633;658;
1001052;"Kluki (2)";4231;4276;4310;4309;873;875;854;828;2621;2644;2675;2694;1646;1661;1682;1697;975;983;993;997;737;757;781;787;
1001062;"Rusiec (2)";5202;5186;5198;5171;969;956;961;936;3204;3186;3190;3175;1973;1968;1966;1972;1231;1218;1224;1203;1029;1044;1047;1060;
1001072;"Szczerców (2)";8025;8080;8121;8097;1622;1582;1566;1548;5115;5175;5192;5147;3264;3310;3312;3275;1851;1865;1880;1872;1288;1323;1363;1402;
1001083;"Zelów (3)";15163;15151;15139;15068;2817;2825;2810;2787;9517;9444;9383;9251;5990;5971;5951;5885;3527;3473;3432;3366;2829;2882;2946;3030;
1001084;"Zelów - miasto (4)";7830;7833;7785;7737;1394;1409;1396;1381;4975;4917;4850;4756;3108;3082;3051;3016;1867;1835;1799;1740;1461;1507;1539;1600;
1001085;"Zelów - obszar wiejski (5)";7333;7318;7354;7331;1423;1416;1414;1406;4542;4527;4533;4495;2882;2889;2900;2869;1660;1638;1633;1626;1368;1375;1407;1430;
1002011;"Kutno (1)";45975;45657;45371;45024;6977;6857;6786;6771;29520;28919;28305;27546;17136;16890;16561;16112;12384;12029;11744;11434;9478;9881;10280;10707;
1002022;"Bedlno (2)";5749;5692;5649;5590;916;894;860;826;3569;3523;3508;3498;2092;2049;2039;2045;1477;1474;1469;1453;1264;1275;1281;1266;
1002032;"Dąbrowice (2)";1981;1952;1943;1923;347;328;322;314;1202;1190;1184;1170;741;731;726;725;461;459;458;445;432;434;437;439;
1002043;"Krośniewice (3)";8864;8763;8714;8695;1549;1494;1464;1438;5598;5529;5465;5411;3343;3290;3269;3247;2255;2239;2196;2164;1717;1740;1785;1846;
1002044;"Krośniewice - miasto (4)";4603;4549;4498;4486;775;744;730;722;2944;2900;2839;2799;1740;1707;1666;1644;1204;1193;1173;1155;884;905;929;965;
1002045;"Krośniewice - obszar wiejski (5)";4261;4214;4216;4209;774;750;734;716;2654;2629;2626;2612;1603;1583;1603;1603;1051;1046;1023;1009;833;835;856;881;
1002052;"Krzyżanów (2)";4349;4332;4292;4298;749;716;696;683;2796;2797;2767;2778;1707;1718;1685;1696;1089;1079;1082;1082;804;819;829;837;
1002062;"Kutno (2)";8742;8698;8783;8723;1579;1543;1537;1481;5713;5673;5715;5668;3524;3473;3510;3474;2189;2200;2205;2194;1450;1482;1531;1574;
1002072;"Łanięta (2)";2547;2507;2490;2470;546;523;500;477;1564;1558;1555;1550;984;965;968;966;580;593;587;584;437;426;435;443;
1002082;"Nowe Ostrowy (2)";3628;3635;3588;3560;655;650;614;587;2287;2284;2258;2253;1386;1374;1360;1367;901;910;898;886;686;701;716;720;
1002092;"Oporów (2)";2660;2632;2639;2633;476;466;462;467;1655;1638;1652;1633;1047;1036;1034;1026;608;602;618;607;529;528;525;533;
1002102;"Strzelce (2)";4086;4050;4065;4059;765;716;707;698;2563;2581;2582;2561;1605;1616;1608;1611;958;965;974;950;758;753;776;800;
1002113;"Żychlin (3)";12596;12489;12433;12283;1940;1898;1872;1848;8034;7919;7809;7632;4628;4574;4536;4450;3406;3345;3273;3182;2622;2672;2752;2803;
1002114;"Żychlin - miasto (4)";8688;8576;8537;8453;1308;1266;1247;1252;5560;5455;5376;5235;3180;3129;3110;3044;2380;2326;2266;2191;1820;1855;1914;1966;
1002115;"Żychlin - obszar wiejski (5)";3908;3913;3896;3830;632;632;625;596;2474;2464;2433;2397;1448;1445;1426;1406;1026;1019;1007;991;802;817;838;837;
1003012;"Buczek (2)";4993;5082;5107;5106;956;991;1002;998;3144;3187;3197;3167;2013;2033;2031;2027;1131;1154;1166;1140;893;904;908;941;
1003023;"Łask (3)";28356;28241;28099;27899;4921;4812;4768;4679;18305;18114;17837;17537;11261;11158;11003;10846;7044;6956;6834;6691;5130;5315;5494;5683;
1003024;"Łask - miasto (4)";18202;18029;17897;17671;2928;2831;2797;2733;11769;11557;11302;10995;7088;7011;6893;6735;4681;4546;4409;4260;3505;3641;3798;3943;
1003025;"Łask - obszar wiejski (5)";10154;10212;10202;10228;1993;1981;1971;1946;6536;6557;6535;6542;4173;4147;4110;4111;2363;2410;2425;2431;1625;1674;1696;1740;
1003032;"Sędziejowice (2)";6388;6411;6411;6395;1155;1156;1169;1138;4007;4011;3977;3988;2537;2545;2503;2494;1470;1466;1474;1494;1226;1244;1265;1269;
1003042;"Widawa (2)";7658;7627;7556;7502;1299;1227;1206;1180;4659;4701;4659;4592;2821;2867;2807;2782;1838;1834;1852;1810;1700;1699;1691;1730;
1003052;"Wodzierady (2)";3256;3326;3378;3380;589;593;590;576;2038;2094;2141;2153;1268;1307;1340;1345;770;787;801;808;629;639;647;651;
1004011;"Łęczyca (1)";14905;14786;14660;14512;2592;2558;2526;2451;9228;9053;8903;8772;5445;5392;5297;5254;3783;3661;3606;3518;3085;3175;3231;3289;
1004022;"Daszyna (2)";4027;3993;3992;3983;699;685;688;692;2453;2438;2433;2402;1490;1473;1467;1453;963;965;966;949;875;870;871;889;
1004032;"Góra Świętej Małgorzaty (2)";4486;4480;4462;4431;867;857;842;829;2691;2691;2669;2628;1667;1651;1645;1609;1024;1040;1024;1019;928;932;951;974;
1004042;"Grabów (2)";6229;6176;6127;6122;1089;1041;1005;987;3829;3810;3775;3768;2299;2315;2315;2325;1530;1495;1460;1443;1311;1325;1347;1367;
1004052;"Łęczyca (2)";8557;8530;8546;8530;1567;1523;1512;1488;5316;5330;5353;5359;3335;3325;3324;3336;1981;2005;2029;2023;1674;1677;1681;1683;
1004062;"Piątek (2)";6265;6241;6194;6188;1113;1102;1080;1074;3906;3893;3851;3817;2383;2372;2348;2346;1523;1521;1503;1471;1246;1246;1263;1297;
1004072;"Świnice Warckie (2)";4086;4076;4024;3986;720;685;663;643;2558;2577;2541;2513;1597;1622;1596;1553;961;955;945;960;808;814;820;830;
1004082;"Witonia (2)";3425;3391;3318;3310;593;567;535;517;2168;2157;2130;2129;1291;1298;1287;1290;877;859;843;839;664;667;653;664;
1005011;"Łowicz (1)";29640;29420;29169;28936;5143;5096;5001;4901;18972;18567;18185;17752;11339;11176;10995;10786;7633;7391;7190;6966;5525;5757;5983;6283;
1005022;"Bielawy (2)";5706;5649;5617;5605;945;915;904;873;3455;3412;3378;3399;2023;2011;1992;2036;1432;1401;1386;1363;1306;1322;1335;1333;
1005032;"Chąśno (2)";3022;2996;2977;2960;606;575;552;527;1841;1832;1845;1837;1131;1118;1135;1131;710;714;710;706;575;589;580;596;
1005042;"Domaniewice (2)";4646;4644;4652;4665;897;903;908;910;2868;2845;2829;2826;1816;1804;1795;1803;1052;1041;1034;1023;881;896;915;929;
1005052;"Kiernozia (2)";3570;3524;3483;3464;665;640;627;604;2175;2151;2116;2104;1323;1314;1294;1322;852;837;822;782;730;733;740;756;
1005062;"Kocierzew Południowy (2)";4400;4399;4361;4332;880;853;847;832;2649;2687;2667;2644;1655;1679;1661;1641;994;1008;1006;1003;871;859;847;856;
1005072;"Łowicz (2)";7529;7577;7634;7646;1505;1504;1482;1460;4680;4728;4782;4806;2972;2996;3043;3056;1708;1732;1739;1750;1344;1345;1370;1380;
1005082;"Łyszkowice (2)";6791;6767;6751;6727;1351;1316;1278;1272;4210;4214;4212;4189;2683;2678;2688;2654;1527;1536;1524;1535;1230;1237;1261;1266;
1005092;"Nieborów (2)";9389;9398;9418;9448;1759;1740;1722;1751;5886;5899;5915;5870;3644;3664;3663;3626;2242;2235;2252;2244;1744;1759;1781;1827;
1005102;"Zduny (2)";5986;5955;5889;5848;1048;1066;1024;1001;3583;3537;3508;3477;2185;2140;2111;2117;1398;1397;1397;1360;1355;1352;1357;1370;
1006022;"Andrespol (2)";13002;13180;13330;13422;2411;2472;2494;2522;8323;8323;8351;8317;5025;5071;5088;5051;3298;3252;3263;3266;2268;2385;2485;2583;
1006032;"Brójce (2)";6171;6217;6321;6390;1289;1277;1300;1321;4007;4049;4097;4098;2546;2570;2606;2608;1461;1479;1491;1490;875;891;924;971;
1006073;"Koluszki (3)";23696;23639;23656;23636;4228;4140;4134;4119;14970;14855;14748;14580;9213;9171;9109;8988;5757;5684;5639;5592;4498;4644;4774;4937;
1006074;"Koluszki - miasto (4)";13542;13419;13370;13302;2347;2277;2269;2261;8644;8499;8359;8222;5299;5234;5147;5042;3345;3265;3212;3180;2551;2643;2742;2819;
1006075;"Koluszki - obszar wiejski (5)";10154;10220;10286;10334;1881;1863;1865;1858;6326;6356;6389;6358;3914;3937;3962;3946;2412;2419;2427;2412;1947;2001;2032;2118;
1006082;"Nowosolna (2)";4491;4556;4635;4721;1002;1005;999;1008;2853;2877;2943;2990;1717;1732;1761;1778;1136;1145;1182;1212;636;674;693;723;
1006103;"Rzgów (3)";9816;9961;9958;10028;1927;1937;1914;1930;6256;6325;6287;6260;3882;3942;3925;3927;2374;2383;2362;2333;1633;1699;1757;1838;
1006104;"Rzgów - miasto (4)";3437;3431;3393;3396;628;607;583;588;2181;2183;2152;2137;1363;1368;1357;1338;818;815;795;799;628;641;658;671;
1006105;"Rzgów - obszar wiejski (5)";6379;6530;6565;6632;1299;1330;1331;1342;4075;4142;4135;4123;2519;2574;2568;2589;1556;1568;1567;1534;1005;1058;1099;1167;
1006113;"Tuszyn (3)";12124;12206;12232;12233;2189;2193;2151;2174;7811;7839;7861;7783;4772;4785;4762;4718;3039;3054;3099;3065;2124;2174;2220;2276;
1006114;"Tuszyn - miasto (4)";7306;7319;7309;7261;1212;1211;1178;1182;4828;4813;4804;4712;2924;2901;2856;2800;1904;1912;1948;1912;1266;1295;1327;1367;
1006115;"Tuszyn - obszar wiejski (5)";4818;4887;4923;4972;977;982;973;992;2983;3026;3057;3071;1848;1884;1906;1918;1135;1142;1151;1153;858;879;893;909;
1007012;"Białaczów (2)";5944;5936;5897;5853;1240;1209;1168;1120;3509;3525;3533;3555;2272;2281;2278;2276;1237;1244;1255;1279;1195;1202;1196;1178;
1007023;"Drzewica (3)";10845;10815;10766;10725;2115;2064;2040;2024;6597;6560;6479;6438;4103;4092;4037;3997;2494;2468;2442;2441;2133;2191;2247;2263;
1007024;"Drzewica - miasto (4)";3994;4008;3984;3962;755;747;743;728;2530;2512;2467;2427;1508;1510;1476;1453;1022;1002;991;974;709;749;774;807;
1007025;"Drzewica - obszar wiejski (5)";6851;6807;6782;6763;1360;1317;1297;1296;4067;4048;4012;4011;2595;2582;2561;2544;1472;1466;1451;1467;1424;1442;1473;1456;
1007032;"Mniszków (2)";4728;4705;4700;4737;961;959;938;936;2865;2856;2871;2905;1841;1823;1838;1858;1024;1033;1033;1047;902;890;891;896;
1007043;"Opoczno (3)";35314;35199;34999;34842;7087;7008;6829;6755;22941;22687;22395;22087;14171;14106;13969;13807;8770;8581;8426;8280;5286;5504;5775;6000;
1007044;"Opoczno - miasto (4)";22318;22188;21965;21847;4163;4110;3945;3923;14928;14666;14378;14087;8932;8860;8709;8549;5996;5806;5669;5538;3227;3412;3642;3837;
1007045;"Opoczno - obszar wiejski (5)";12996;13011;13034;12995;2924;2898;2884;2832;8013;8021;8017;8000;5239;5246;5260;5258;2774;2775;2757;2742;2059;2092;2133;2163;
1007052;"Paradyż (2)";4453;4432;4468;4470;1041;1012;1011;988;2670;2681;2693;2715;1722;1738;1750;1774;948;943;943;941;742;739;764;767;
1007062;"Poświętne (2)";3316;3313;3267;3237;607;605;597;570;1973;1974;1934;1921;1219;1212;1170;1171;754;762;764;750;736;734;736;746;
1007072;"Sławno (2)";7531;7538;7584;7554;1732;1700;1690;1672;4525;4551;4581;4570;2926;2959;2982;2995;1599;1592;1599;1575;1274;1287;1313;1312;
1007082;"Żarnów (2)";6103;6119;6090;6039;1101;1072;1048;1014;3682;3727;3723;3699;2278;2306;2279;2256;1404;1421;1444;1443;1320;1320;1319;1326;
1008011;"Konstantynów Łódzki (1)";17757;17804;17857;17807;2838;2848;2860;2825;11383;11260;11115;10977;6838;6839;6810;6762;4545;4421;4305;4215;3536;3696;3882;4005;
1008021;"Pabianice (1)";68321;67688;67207;66895;10353;10156;10076;10049;42631;41860;41188;40595;25971;25597;25237;24938;16660;16263;15951;15657;15337;15672;15943;16251;
1008032;"Dłutów (2)";4355;4429;4476;4495;823;829;818;815;2688;2759;2805;2789;1683;1731;1764;1750;1005;1028;1041;1039;844;841;853;891;
1008042;"Dobroń (2)";7405;7461;7473;7544;1384;1368;1367;1370;4782;4800;4775;4780;3043;3058;3022;3035;1739;1742;1753;1745;1239;1293;1331;1394;
1008052;"Ksawerów (2)";7559;7615;7666;7673;1374;1388;1417;1402;4741;4727;4709;4688;2983;2999;2972;2955;1758;1728;1737;1733;1444;1500;1540;1583;
1008062;"Lutomiersk (2)";7807;7945;8027;8129;1471;1491;1515;1529;4866;4931;4930;4997;2992;3017;3034;3059;1874;1914;1896;1938;1470;1523;1582;1603;
1008072;"Pabianice (2)";6553;6730;6876;6975;1282;1337;1376;1413;4232;4289;4352;4382;2649;2691;2747;2740;1583;1598;1605;1642;1039;1104;1148;1180;
1009013;"Działoszyn (3)";12928;12872;12825;12722;2493;2422;2354;2295;8205;8175;8167;8077;5059;5039;5022;4921;3146;3136;3145;3156;2230;2275;2304;2350;
1009014;"Działoszyn - miasto (4)";6264;6173;6147;6089;1112;1066;1037;1003;4090;4007;3973;3897;2468;2402;2379;2309;1622;1605;1594;1588;1062;1100;1137;1189;
1009015;"Działoszyn - obszar wiejski (5)";6664;6699;6678;6633;1381;1356;1317;1292;4115;4168;4194;4180;2591;2637;2643;2612;1524;1531;1551;1568;1168;1175;1167;1161;
1009022;"Kiełczygłów (2)";4205;4198;4170;4112;717;694;668;637;2552;2557;2549;2531;1572;1569;1558;1529;980;988;991;1002;936;947;953;944;
1009032;"Nowa Brzeźnica (2)";4759;4729;4710;4663;840;804;771;740;3006;3000;2982;2939;1865;1856;1856;1839;1141;1144;1126;1100;913;925;957;984;
1009043;"Pajęczno (3)";11783;11759;11720;11713;2181;2172;2119;2074;7462;7378;7323;7245;4622;4578;4566;4555;2840;2800;2757;2690;2140;2209;2278;2394;
1009044;"Pajęczno - miasto (4)";6817;6811;6791;6808;1194;1203;1202;1198;4373;4298;4218;4168;2663;2650;2630;2624;1710;1648;1588;1544;1250;1310;1371;1442;
1009045;"Pajęczno - obszar wiejski (5)";4966;4948;4929;4905;987;969;917;876;3089;3080;3105;3077;1959;1928;1936;1931;1130;1152;1169;1146;890;899;907;952;
1009052;"Rząśnia (2)";4867;4851;4820;4804;1006;964;945;896;2927;2957;2954;2977;1938;1975;1958;1979;989;982;996;998;934;930;921;931;
1009062;"Siemkowice (2)";4853;4854;4852;4858;1013;995;965;976;2925;2926;2947;2925;1841;1865;1878;1873;1084;1061;1069;1052;915;933;940;957;
1009072;"Strzelce Wielkie (2)";4740;4713;4700;4685;856;820;796;798;2981;2984;2978;2961;1863;1873;1868;1841;1118;1111;1110;1120;903;909;926;926;
1009082;"Sulmierzyce (2)";4565;4557;4496;4466;832;815;772;769;2830;2816;2783;2740;1743;1734;1723;1707;1087;1082;1060;1033;903;926;941;957;
1010012;"Aleksandrów (2)";4407;4391;4383;4384;824;803;787;788;2624;2633;2653;2635;1600;1605;1622;1614;1024;1028;1031;1021;959;955;943;961;
1010022;"Czarnocin (2)";4098;4143;4078;4076;803;820;786;788;2568;2588;2549;2518;1597;1592;1556;1560;971;996;993;958;727;735;743;770;
1010032;"Gorzkowice (2)";8671;8606;8607;8542;1815;1766;1740;1695;5298;5253;5254;5221;3394;3406;3423;3408;1904;1847;1831;1813;1558;1587;1613;1626;
1010042;"Grabica (2)";6086;6127;6134;6101;1274;1270;1275;1234;3738;3760;3750;3744;2405;2439;2433;2441;1333;1321;1317;1303;1074;1097;1109;1123;
1010052;"Łęki Szlacheckie (2)";3646;3630;3602;3570;766;747;724;683;2144;2144;2134;2147;1334;1340;1337;1339;810;804;797;808;736;739;744;740;
1010062;"Moszczenica (2)";12910;12909;12915;12829;2589;2544;2514;2468;8011;8003;7994;7930;5093;5087;5078;4997;2918;2916;2916;2933;2310;2362;2407;2431;
1010072;"Ręczno (2)";3608;3598;3570;3566;679;648;638;621;2208;2211;2196;2194;1356;1366;1345;1353;852;845;851;841;721;739;736;751;
1010082;"Rozprza (2)";12241;12287;12274;12344;2527;2520;2510;2516;7629;7611;7572;7588;4926;4948;4910;4945;2703;2663;2662;2643;2085;2156;2192;2240;
1010093;"Sulejów (3)";16268;16280;16308;16245;3305;3246;3177;3148;10273;10268;10288;10181;6520;6504;6498;6422;3753;3764;3790;3759;2690;2766;2843;2916;
1010094;"Sulejów - miasto (4)";6446;6376;6360;6308;1224;1191;1161;1143;4141;4074;4060;3982;2553;2498;2482;2444;1588;1576;1578;1538;1081;1111;1139;1183;
1010095;"Sulejów - obszar wiejski (5)";9822;9904;9948;9937;2081;2055;2016;2005;6132;6194;6228;6199;3967;4006;4016;3978;2165;2188;2212;2221;1609;1655;1704;1733;
1010102;"Wola Krzysztoporska (2)";11832;11847;11889;11895;2578;2578;2550;2498;7232;7190;7227;7244;4744;4709;4744;4741;2488;2481;2483;2503;2022;2079;2112;2153;
1010113;"Wolbórz (3)";7753;7800;7774;7731;1425;1465;1472;1460;4930;4927;4860;4809;3139;3121;3056;3015;1791;1806;1804;1794;1398;1408;1442;1462;
1010114;"Wolbórz - miasto (4)";2365;2388;2362;2346;438;476;482;481;1556;1531;1489;1453;982;960;917;889;574;571;572;564;371;381;391;412;
1010115;"Wolbórz - obszar wiejski (5)";5388;5412;5412;5385;987;989;990;979;3374;3396;3371;3356;2157;2161;2139;2126;1217;1235;1232;1230;1027;1027;1051;1050;
1011012;"Dalików (2)";3847;3859;3847;3854;729;729;710;708;2395;2383;2379;2369;1482;1489;1483;1479;913;894;896;890;723;747;758;777;
1011022;"Pęczniew (2)";3505;3522;3522;3525;617;610;613;599;2161;2179;2167;2173;1289;1304;1306;1304;872;875;861;869;727;733;742;753;
1011033;"Poddębice (3)";15907;15914;15910;15857;2867;2827;2789;2758;10110;10073;10008;9923;6265;6259;6204;6109;3845;3814;3804;3814;2930;3014;3113;3176;
1011034;"Poddębice - miasto (4)";7812;7780;7771;7724;1368;1346;1326;1321;5005;4938;4889;4815;3102;3066;3034;2955;1903;1872;1855;1860;1439;1496;1556;1588;
1011035;"Poddębice - obszar wiejski (5)";8095;8134;8139;8133;1499;1481;1463;1437;5105;5135;5119;5108;3163;3193;3170;3154;1942;1942;1949;1954;1491;1518;1557;1588;
1011043;"Uniejów (3)";7186;7238;7183;7126;1186;1186;1155;1133;4411;4423;4390;4317;2696;2701;2663;2643;1715;1722;1727;1674;1589;1629;1638;1676;
1011044;"Uniejów - miasto (4)";3021;3079;3051;3015;465;480;472;456;1893;1906;1876;1840;1155;1158;1123;1105;738;748;753;735;663;693;703;719;
1011045;"Uniejów - obszar wiejski (5)";4165;4159;4132;4111;721;706;683;677;2518;2517;2514;2477;1541;1543;1540;1538;977;974;974;939;926;936;935;957;
1011052;"Wartkowice (2)";6318;6282;6284;6295;1165;1104;1083;1070;3947;3979;3961;3974;2477;2518;2490;2469;1470;1461;1471;1505;1206;1199;1240;1251;
1011062;"Zadzim (2)";5118;5056;5042;5022;883;825;807;819;3106;3086;3074;3035;1863;1856;1858;1845;1243;1230;1216;1190;1129;1145;1161;1168;
1012011;"Radomsko (1)";47947;47643;47399;47070;8035;7901;7758;7626;30199;29705;29301;28863;18213;17986;17767;17501;11986;11719;11534;11362;9713;10037;10340;10581;
1012022;"Dobryszyce (2)";4398;4432;4392;4395;939;951;915;894;2755;2756;2749;2754;1765;1770;1756;1766;990;986;993;988;704;725;728;747;
1012032;"Gidle (2)";6360;6310;6292;6231;1081;1042;1021;1004;3980;3950;3954;3898;2396;2384;2371;2334;1584;1566;1583;1564;1299;1318;1317;1329;
1012042;"Gomunice (2)";6021;5948;5948;5922;1169;1118;1085;1072;3771;3731;3732;3672;2347;2315;2317;2299;1424;1416;1415;1373;1081;1099;1131;1178;
1012053;"Kamieńsk (3)";6122;6117;6107;6093;1225;1202;1169;1139;3849;3842;3833;3834;2453;2440;2413;2401;1396;1402;1420;1433;1048;1073;1105;1120;
1012054;"Kamieńsk - miasto (4)";2893;2890;2875;2858;559;546;537;509;1899;1898;1869;1863;1183;1182;1153;1149;716;716;716;714;435;446;469;486;
1012055;"Kamieńsk - obszar wiejski (5)";3229;3227;3232;3235;666;656;632;630;1950;1944;1964;1971;1270;1258;1260;1252;680;686;704;719;613;627;636;634;
1012062;"Kobiele Wielkie (2)";4487;4512;4471;4478;895;881;842;847;2805;2820;2804;2789;1773;1795;1780;1758;1032;1025;1024;1031;787;811;825;842;
1012072;"Kodrąb (2)";4700;4712;4649;4608;901;900;874;863;2883;2862;2806;2777;1818;1809;1763;1735;1065;1053;1043;1042;916;950;969;968;
1012082;"Lgota Wielka (2)";4368;4364;4359;4334;858;840;823;808;2725;2730;2735;2717;1774;1765;1767;1765;951;965;968;952;785;794;801;809;
1012092;"Ładzice (2)";4905;4872;4855;4841;1003;954;937;910;3031;3010;2994;2983;1900;1903;1881;1879;1131;1107;1113;1104;871;908;924;948;
1012102;"Masłowice (2)";4274;4266;4294;4228;799;793;769;750;2585;2571;2621;2571;1612;1608;1634;1615;973;963;987;956;890;902;904;907;
1012113;"Przedbórz (3)";7455;7371;7361;7297;1370;1299;1282;1235;4671;4640;4630;4607;2910;2913;2904;2888;1761;1727;1726;1719;1414;1432;1449;1455;
1012114;"Przedbórz - miasto (4)";3737;3687;3697;3647;627;592;584;568;2494;2446;2438;2395;1528;1497;1505;1487;966;949;933;908;616;649;675;684;
1012115;"Przedbórz - obszar wiejski (5)";3718;3684;3664;3650;743;707;698;667;2177;2194;2192;2212;1382;1416;1399;1401;795;778;793;811;798;783;774;771;
1012122;"Radomsko (2)";5634;5624;5631;5621;1081;1037;1013;983;3568;3546;3547;3547;2296;2280;2258;2255;1272;1266;1289;1292;985;1041;1071;1091;
1012132;"Wielgomłyny (2)";4811;4772;4738;4720;906;884;860;842;2923;2903;2899;2891;1836;1818;1817;1817;1087;1085;1082;1074;982;985;979;987;
1012142;"Żytno (2)";5399;5373;5336;5287;941;922;902;878;3229;3221;3199;3159;1894;1916;1912;1907;1335;1305;1287;1252;1229;1230;1235;1250;
1013011;"Rawa Mazowiecka (1)";17819;17819;17737;17608;3193;3225;3222;3198;11703;11511;11275;10997;6970;6887;6782;6667;4733;4624;4493;4330;2923;3083;3240;3413;
1013023;"Biała Rawska (3)";11579;11555;11484;11473;2237;2193;2165;2128;7222;7223;7132;7117;4435;4443;4385;4407;2787;2780;2747;2710;2120;2139;2187;2228;
1013024;"Biała Rawska - miasto (4)";3272;3244;3237;3215;627;630;639;620;2155;2104;2061;2044;1265;1236;1209;1207;890;868;852;837;490;510;537;551;
1013025;"Biała Rawska - obszar wiejski (5)";8307;8311;8247;8258;1610;1563;1526;1508;5067;5119;5071;5073;3170;3207;3176;3200;1897;1912;1895;1873;1630;1629;1650;1677;
1013032;"Cielądz (2)";4084;4072;4076;4049;793;776;770;756;2552;2542;2552;2537;1562;1562;1575;1567;990;980;977;970;739;754;754;756;
1013042;"Rawa Mazowiecka (2)";8622;8671;8666;8696;1740;1717;1702;1670;5359;5394;5393;5437;3339;3354;3355;3401;2020;2040;2038;2036;1523;1560;1571;1589;
1013052;"Regnów (2)";1854;1846;1849;1837;382;365;359;354;1098;1100;1125;1122;706;708;728;726;392;392;397;396;374;381;365;361;
1013062;"Sadkowice (2)";5654;5614;5607;5576;1097;1068;1066;1039;3411;3401;3370;3355;2138;2122;2104;2109;1273;1279;1266;1246;1146;1145;1171;1182;
1014011;"Sieradz (1)";43651;43356;43071;42890;7440;7258;7094;7036;28413;27976;27584;27114;16926;16731;16525;16271;11487;11245;11059;10843;7798;8122;8393;8740;
1014023;"Błaszki (3)";14953;14947;14866;14790;2926;2861;2790;2756;9314;9336;9293;9229;5983;5977;5932;5866;3331;3359;3361;3363;2713;2750;2783;2805;
1014024;"Błaszki - miasto (4)";2298;2273;2241;2248;445;430;414;425;1417;1399;1371;1360;870;857;849;845;547;542;522;515;436;444;456;463;
1014025;"Błaszki - obszar wiejski (5)";12655;12674;12625;12542;2481;2431;2376;2331;7897;7937;7922;7869;5113;5120;5083;5021;2784;2817;2839;2848;2277;2306;2327;2342;
1014032;"Brąszewice (2)";4455;4511;4526;4524;1007;995;988;972;2688;2773;2789;2797;1770;1833;1852;1863;918;940;937;934;760;743;749;755;
1014042;"Brzeźnio (2)";6341;6301;6338;6357;1282;1264;1245;1228;3878;3850;3879;3880;2544;2487;2512;2506;1334;1363;1367;1374;1181;1187;1214;1249;
1014052;"Burzenin (2)";5664;5641;5600;5567;1053;1019;978;973;3535;3540;3504;3456;2224;2231;2196;2177;1311;1309;1308;1279;1076;1082;1118;1138;
1014062;"Goszczanów (2)";5686;5668;5626;5575;1171;1142;1123;1087;3405;3408;3382;3366;2175;2175;2147;2144;1230;1233;1235;1222;1110;1118;1121;1122;
1014072;"Klonowa (2)";2969;2982;2962;2932;612;607;587;573;1770;1798;1801;1787;1160;1168;1166;1149;610;630;635;638;587;577;574;572;
1014082;"Sieradz (2)";10318;10400;10387;10399;2146;2138;2096;2067;6484;6534;6544;6542;4204;4205;4195;4189;2280;2329;2349;2353;1688;1728;1747;1790;
1014093;"Warta (3)";12961;12893;12880;12897;2435;2366;2310;2285;7886;7897;7908;7884;4910;4919;4890;4892;2976;2978;3018;2992;2640;2630;2662;2728;
1014094;"Warta - miasto (4)";3354;3337;3339;3326;571;554;559;556;2113;2108;2074;2041;1256;1261;1239;1228;857;847;835;813;670;675;706;729;
1014095;"Warta - obszar wiejski (5)";9607;9556;9541;9571;1864;1812;1751;1729;5773;5789;5834;5843;3654;3658;3651;3664;2119;2131;2183;2179;1970;1955;1956;1999;
1014102;"Wróblew (2)";6085;6086;6109;6110;1133;1116;1101;1093;3764;3776;3795;3760;2359;2378;2404;2399;1405;1398;1391;1361;1188;1194;1213;1257;
1014113;"Złoczew (3)";7327;7272;7257;7227;1503;1430;1413;1392;4540;4540;4532;4517;2950;2940;2919;2912;1590;1600;1613;1605;1284;1302;1312;1318;
1014114;"Złoczew - miasto (4)";3389;3377;3378;3355;668;634;628;622;2152;2158;2160;2143;1378;1383;1380;1374;774;775;780;769;569;585;590;590;
1014115;"Złoczew - obszar wiejski (5)";3938;3895;3879;3872;835;796;785;770;2388;2382;2372;2374;1572;1557;1539;1538;816;825;833;836;715;717;722;728;
1015012;"Bolimów (2)";4114;4044;4042;4045;805;772;771;768;2522;2474;2464;2458;1571;1553;1541;1529;951;921;923;929;787;798;807;819;
1015022;"Głuchów (2)";5921;5910;5875;5842;1250;1252;1227;1203;3499;3486;3470;3450;2212;2203;2177;2160;1287;1283;1293;1290;1172;1172;1178;1189;
1015032;"Godzianów (2)";2625;2613;2616;2595;542;526;514;513;1628;1646;1648;1634;1011;1023;1029;1017;617;623;619;617;455;441;454;448;
1015042;"Kowiesy (2)";2993;3012;2983;2937;551;552;536;521;1832;1847;1827;1807;1112;1128;1113;1094;720;719;714;713;610;613;620;609;
1015052;"Lipce Reymontowskie (2)";3303;3289;3285;3293;636;629;642;635;2013;1983;1974;1978;1264;1255;1245;1250;749;728;729;728;654;677;669;680;
1015062;"Maków (2)";6010;6053;6014;5996;1190;1168;1144;1144;3666;3711;3694;3685;2326;2374;2354;2328;1340;1337;1340;1357;1154;1174;1176;1167;
1015072;"Nowy Kawęczyn (2)";3340;3354;3364;3375;617;614;604;604;2065;2070;2094;2109;1266;1277;1304;1296;799;793;790;813;658;670;666;662;
1015082;"Skierniewice (2)";7290;7305;7324;7392;1445;1442;1434;1445;4557;4575;4569;4566;2878;2890;2889;2893;1679;1685;1680;1673;1288;1288;1321;1381;
1015092;"Słupia (2)";2717;2712;2695;2702;568;553;556;553;1631;1626;1605;1607;1055;1073;1054;1058;576;553;551;549;518;533;534;542;
1016011;"Tomaszów Mazowiecki (1)";65454;64893;64513;63960;11374;11147;11056;10845;40637;39774;39069;38299;24633;24319;24002;23672;16004;15455;15067;14627;13443;13972;14388;14816;
1016022;"Będków (2)";3374;3339;3344;3323;599;559;548;558;2100;2087;2091;2064;1299;1288;1303;1289;801;799;788;775;675;693;705;701;
1016032;"Budziszewice (2)";2256;2253;2219;2201;476;452;437;433;1381;1390;1383;1364;859;876;870;856;522;514;513;508;399;411;399;404;
1016042;"Czerniewice (2)";5179;5172;5166;5138;1024;1028;1018;999;3275;3252;3250;3242;2048;2036;2048;2029;1227;1216;1202;1213;880;892;898;897;
1016052;"Inowłódz (2)";3921;3900;3872;3861;689;654;637;635;2405;2395;2393;2358;1420;1442;1429;1412;985;953;964;946;827;851;842;868;
1016062;"Lubochnia (2)";7260;7190;7199;7211;1599;1568;1595;1576;4542;4466;4400;4410;2959;2898;2844;2857;1583;1568;1556;1553;1119;1156;1204;1225;
1016072;"Rokiciny (2)";6193;6186;6180;6167;1158;1121;1108;1090;3724;3760;3766;3759;2362;2378;2384;2370;1362;1382;1382;1389;1311;1305;1306;1318;
1016082;"Rzeczyca (2)";4811;4761;4728;4717;935;870;831;836;2935;2947;2931;2923;1830;1843;1827;1814;1105;1104;1104;1109;941;944;966;958;
1016092;"Tomaszów Mazowiecki (2)";10651;10772;10773;10845;2206;2215;2176;2166;6819;6909;6907;6920;4315;4399;4372;4361;2504;2510;2535;2559;1626;1648;1690;1759;
1016102;"Ujazd (2)";7917;7928;7906;7874;1497;1503;1493;1501;5042;4979;4924;4841;3098;3082;3055;3001;1944;1897;1869;1840;1378;1446;1489;1532;
1016112;"Żelechlinek (2)";3367;3365;3373;3374;674;692;700;701;1995;1983;1973;1953;1265;1243;1247;1230;730;740;726;723;698;690;700;720;
1017012;"Biała (2)";5583;5536;5515;5521;1114;1080;1053;1055;3446;3416;3398;3396;2235;2207;2199;2196;1211;1209;1199;1200;1023;1040;1064;1070;
1017022;"Czarnożyły (2)";4562;4559;4569;4544;903;889;891;870;2786;2786;2786;2771;1737;1733;1741;1734;1049;1053;1045;1037;873;884;892;903;
1017032;"Konopnica (2)";3888;3883;3911;3833;707;700;701;661;2347;2331;2347;2305;1429;1442;1467;1445;918;889;880;860;834;852;863;867;
1017042;"Mokrsko (2)";5376;5422;5465;5437;1094;1114;1123;1099;3323;3320;3340;3310;2074;2088;2103;2077;1249;1232;1237;1233;959;988;1002;1028;
1017052;"Osjaków (2)";4812;4810;4810;4770;994;975;969;948;2933;2931;2943;2921;1866;1869;1858;1845;1067;1062;1085;1076;885;904;898;901;
1017062;"Ostrówek (2)";4596;4563;4539;4543;894;875;846;854;2847;2818;2821;2819;1778;1757;1749;1732;1069;1061;1072;1087;855;870;872;870;
1017072;"Pątnów (2)";6547;6533;6539;6557;1402;1371;1338;1328;3985;3987;4000;4024;2601;2577;2591;2597;1384;1410;1409;1427;1160;1175;1201;1205;
1017082;"Skomlin (2)";3384;3428;3394;3394;713;705;687;681;2100;2143;2125;2119;1335;1385;1387;1383;765;758;738;736;571;580;582;594;
1017093;"Wieluń (3)";32698;32443;32191;32080;5721;5590;5494;5468;20986;20622;20237;19985;12516;12335;12137;12024;8470;8287;8100;7961;5991;6231;6460;6627;
1017094;"Wieluń - miasto (4)";23837;23546;23300;23169;4039;3932;3817;3787;15442;15040;14714;14472;9043;8840;8672;8543;6399;6200;6042;5929;4356;4574;4769;4910;
1017095;"Wieluń - obszar wiejski (5)";8861;8897;8891;8911;1682;1658;1677;1681;5544;5582;5523;5513;3473;3495;3465;3481;2071;2087;2058;2032;1635;1657;1691;1717;
1017102;"Wierzchlas (2)";6538;6543;6580;6611;1234;1209;1201;1181;4062;4067;4111;4161;2548;2553;2576;2598;1514;1514;1535;1563;1242;1267;1268;1269;
1018012;"Bolesławiec (2)";4082;4079;4072;4063;738;717;696;691;2583;2606;2606;2594;1554;1581;1583;1577;1029;1025;1023;1017;761;756;770;778;
1018022;"Czastary (2)";3934;3985;3953;3959;779;781;780;780;2476;2512;2475;2461;1571;1602;1585;1567;905;910;890;894;679;692;698;718;
1018032;"Galewice (2)";6263;6198;6248;6247;1248;1208;1204;1187;3970;3962;3987;3998;2550;2531;2547;2553;1420;1431;1440;1445;1045;1028;1057;1062;
1018042;"Lututów (2)";4616;4615;4645;4628;930;910;911;895;2898;2878;2886;2868;1807;1806;1821;1819;1091;1072;1065;1049;788;827;848;865;
1018052;"Łubnice (2)";4143;4155;4131;4118;848;846;817;792;2542;2548;2547;2558;1614;1628;1614;1625;928;920;933;933;753;761;767;768;
1018062;"Sokolniki (2)";4896;4890;4872;4893;953;930;894;875;3056;3051;3045;3066;1938;1943;1954;1956;1118;1108;1091;1110;887;909;933;952;
1018073;"Wieruszów (3)";14347;14338;14275;14287;2894;2867;2767;2720;9171;9092;8990;8942;5820;5759;5690;5668;3351;3333;3300;3274;2282;2379;2518;2625;
1018074;"Wieruszów - miasto (4)";8745;8723;8653;8634;1650;1636;1583;1541;5660;5578;5459;5404;3515;3475;3407;3380;2145;2103;2052;2024;1435;1509;1611;1689;
1018075;"Wieruszów - obszar wiejski (5)";5602;5615;5622;5653;1244;1231;1184;1179;3511;3514;3531;3538;2305;2284;2283;2288;1206;1230;1248;1250;847;870;907;936;
1019011;"Zduńska Wola (1)";43920;43615;43310;42998;7827;7733;7565;7463;27824;27379;26985;26546;16975;16750;16534;16312;10849;10629;10451;10234;8269;8503;8760;8989;
1019023;"Szadek (3)";7424;7383;7420;7386;1403;1339;1305;1287;4601;4584;4617;4590;2912;2897;2943;2935;1689;1687;1674;1655;1420;1460;1498;1509;
1019024;"Szadek - miasto (4)";2038;2019;2024;1994;388;373;358;338;1254;1240;1253;1232;805;795;815;803;449;445;438;429;396;406;413;424;
1019025;"Szadek - obszar wiejski (5)";5386;5364;5396;5392;1015;966;947;949;3347;3344;3364;3358;2107;2102;2128;2132;1240;1242;1236;1226;1024;1054;1085;1085;
1019032;"Zapolice (2)";4939;4988;5019;5078;932;919;905;914;3201;3239;3269;3286;2028;2046;2082;2089;1173;1193;1187;1197;806;830;845;878;
1019042;"Zduńska Wola (2)";11840;11942;11999;12021;2523;2543;2493;2422;7417;7443;7509;7545;4912;4912;4892;4886;2505;2531;2617;2659;1900;1956;1997;2054;
1020011;"Głowno (1)";14966;14814;14759;14590;2514;2459;2398;2339;9389;9208;9129;8899;5630;5530;5487;5422;3759;3678;3642;3477;3063;3147;3232;3352;
1020021;"Ozorków (1)";20286;20175;20068;19879;3390;3354;3310;3254;13014;12826;12624;12350;7925;7841;7714;7574;5089;4985;4910;4776;3882;3995;4134;4275;
1020031;"Zgierz (1)";57803;57503;57390;57234;9448;9310;9226;9248;36188;35599;35159;34680;22127;21949;21686;21396;14061;13650;13473;13284;12167;12594;13005;13306;
1020043;"Aleksandrów Łódzki (3)";29432;29862;30285;30645;5406;5542;5674;5764;18756;18879;18935;18988;11554;11669;11691;11730;7202;7210;7244;7258;5270;5441;5676;5893;
1020044;"Aleksandrów Łódzki - miasto (4)";21184;21245;21224;21354;3604;3632;3615;3665;13431;13348;13188;13138;8195;8168;8069;8049;5236;5180;5119;5089;4149;4265;4421;4551;
1020045;"Aleksandrów Łódzki - obszar wiejski (5)";8248;8617;9061;9291;1802;1910;2059;2099;5325;5531;5747;5850;3359;3501;3622;3681;1966;2030;2125;2169;1121;1176;1255;1342;
1020052;"Głowno (2)";4853;4894;4856;4852;890;874;855;842;3011;3060;3045;3050;1902;1949;1923;1928;1109;1111;1122;1122;952;960;956;960;
1020062;"Ozorków (2)";6878;6910;6917;6892;1301;1260;1247;1201;4301;4341;4348;4320;2649;2671;2675;2663;1652;1670;1673;1657;1276;1309;1322;1371;
1020072;"Parzęczew (2)";5035;4983;4987;5000;999;977;959;953;3236;3195;3207;3198;2074;2042;2041;2031;1162;1153;1166;1167;800;811;821;849;
1020083;"Stryków (3)";12431;12375;12412;12445;2299;2250;2257;2256;7828;7769;7740;7697;4787;4768;4739;4728;3041;3001;3001;2969;2304;2356;2415;2492;
1020084;"Stryków - miasto (4)";3552;3537;3536;3492;635;630;633;606;2249;2213;2187;2162;1332;1314;1309;1295;917;899;878;867;668;694;716;724;
1020085;"Stryków - obszar wiejski (5)";8879;8838;8876;8953;1664;1620;1624;1650;5579;5556;5553;5535;3455;3454;3430;3433;2124;2102;2123;2102;1636;1662;1699;1768;
1020092;"Zgierz (2)";12913;13165;13314;13593;2474;2484;2450;2477;8101;8235;8317;8431;4919;5060;5057;5134;3182;3175;3260;3297;2338;2446;2547;2685;
1021011;"Brzeziny (1)";12587;12577;12577;12542;2202;2178;2207;2172;8197;8118;7992;7881;5050;5013;4959;4869;3147;3105;3033;3012;2188;2281;2378;2489;
1021022;"Brzeziny (2)";5514;5557;5574;5616;1108;1100;1081;1100;3401;3409;3427;3431;2196;2208;2211;2198;1205;1201;1216;1233;1005;1048;1066;1085;
1021032;"Dmosin (2)";4581;4554;4529;4537;788;769;773;774;2816;2814;2774;2772;1679;1686;1649;1642;1137;1128;1125;1130;977;971;982;991;
1021042;"Jeżów (2)";3489;3474;3476;3464;640;631;619;601;2151;2135;2142;2132;1304;1286;1291;1295;847;849;851;837;698;708;715;731;
1021052;"Rogów (2)";4785;4761;4789;4774;857;838;852;837;3011;2992;2985;2958;1880;1867;1867;1851;1131;1125;1118;1107;917;931;952;979;
1061011;"Łódź (1)";718960;711332;706004;700982;101392;100567;100275;100175;449072;438012;428845;419804;267515;263246;260156;256897;181557;174766;168689;162907;168496;172753;176884;181003;
1062011;"Piotrków Trybunalski (1)";76404;75903;75608;75183;13476;13349;13207;13150;48049;47134;46396;45499;29380;28957;28650;28222;18669;18177;17746;17277;14879;15420;16005;16534;
1063011;"Skierniewice (1)";48695;48634;48660;48388;8804;8704;8747;8734;31373;30999;30554;29888;18861;18799;18701;18306;12512;12200;11853;11582;8518;8931;9359;9766;
1201011;"Bochnia (1)";30303;30219;30104;30107;5951;5931;5899;5904;19227;18858;18556;18311;12344;12162;12016;11897;6883;6696;6540;6414;5125;5430;5649;5892;
1201022;"Bochnia (2)";19091;19305;19421;19530;4027;4055;4060;4019;12166;12283;12325;12364;7939;8005;8043;8086;4227;4278;4282;4278;2898;2967;3036;3147;
1201032;"Drwinia (2)";6539;6513;6484;6535;1315;1285;1259;1273;4129;4123;4083;4101;2662;2649;2641;2663;1467;1474;1442;1438;1095;1105;1142;1161;
1201042;"Lipnica Murowana (2)";5553;5574;5587;5601;1274;1249;1247;1226;3495;3542;3541;3549;2271;2318;2325;2329;1224;1224;1216;1220;784;783;799;826;
1201052;"Łapanów (2)";7772;7841;7895;7934;1811;1801;1794;1784;4874;4947;4983;5037;3245;3284;3310;3327;1629;1663;1673;1710;1087;1093;1118;1113;
1201063;"Nowy Wiśnicz (3)";13459;13563;13682;13759;3109;3132;3125;3116;8383;8415;8501;8542;5554;5558;5608;5631;2829;2857;2893;2911;1967;2016;2056;2101;
1201064;"Nowy Wiśnicz - miasto (4)";2768;2757;2767;2761;574;601;593;593;1772;1722;1722;1711;1150;1105;1108;1105;622;617;614;606;422;434;452;457;
1201065;"Nowy Wiśnicz - obszar wiejski (5)";10691;10806;10915;10998;2535;2531;2532;2523;6611;6693;6779;6831;4404;4453;4500;4526;2207;2240;2279;2305;1545;1582;1604;1644;
1201072;"Rzezawa (2)";11072;11087;11128;11117;2382;2331;2299;2259;7150;7194;7219;7217;4690;4728;4736;4727;2460;2466;2483;2490;1540;1562;1610;1641;
1201082;"Trzciana (2)";5352;5373;5405;5428;1274;1219;1220;1218;3282;3354;3387;3413;2227;2251;2262;2266;1055;1103;1125;1147;796;800;798;797;
1201092;"Żegocina (2)";5263;5290;5377;5405;1232;1215;1245;1246;3305;3330;3373;3375;2213;2227;2259;2256;1092;1103;1114;1119;726;745;759;784;
1202012;"Borzęcin (2)";8446;8426;8424;8397;1738;1669;1622;1547;5339;5362;5407;5421;3484;3490;3497;3474;1855;1872;1910;1947;1369;1395;1395;1429;
1202023;"Brzesko (3)";36343;36310;36342;36295;7239;7106;7007;6868;23340;23204;23169;23067;14980;14928;14841;14742;8360;8276;8328;8325;5764;6000;6166;6360;
1202024;"Brzesko - miasto (4)";17193;17097;17090;17026;3090;3055;3063;3015;11082;10861;10723;10590;7017;6936;6871;6791;4065;3925;3852;3799;3021;3181;3304;3421;
1202025;"Brzesko - obszar wiejski (5)";19150;19213;19252;19269;4149;4051;3944;3853;12258;12343;12446;12477;7963;7992;7970;7951;4295;4351;4476;4526;2743;2819;2862;2939;
1202033;"Czchów (3)";9640;9670;9724;9813;2203;2167;2152;2188;5994;6031;6079;6077;4034;4056;4067;4079;1960;1975;2012;1998;1443;1472;1493;1548;
1202034;"Czchów - miasto (4)";2364;2346;2364;2368;507;496;484;487;1465;1448;1468;1457;956;934;935;933;509;514;533;524;392;402;412;424;
1202035;"Czchów - obszar wiejski (5)";7276;7324;7360;7445;1696;1671;1668;1701;4529;4583;4611;4620;3078;3122;3132;3146;1451;1461;1479;1474;1051;1070;1081;1124;
1202042;"Dębno (2)";14467;14519;14560;14607;3150;3079;3034;2946;9154;9218;9268;9328;6110;6138;6150;6186;3044;3080;3118;3142;2163;2222;2258;2333;
1202052;"Gnojnik (2)";7724;7824;7858;7889;1867;1884;1862;1845;4763;4829;4845;4853;3183;3219;3228;3226;1580;1610;1617;1627;1094;1111;1151;1191;
1202062;"Iwkowa (2)";6254;6286;6291;6320;1567;1543;1498;1499;3695;3742;3765;3796;2474;2496;2512;2525;1221;1246;1253;1271;992;1001;1028;1025;
1202072;"Szczurowa (2)";9771;9746;9709;9662;1890;1828;1791;1763;6135;6153;6150;6102;3911;3950;3923;3894;2224;2203;2227;2208;1746;1765;1768;1797;
1203013;"Alwernia (3)";12793;12739;12727;12684;2181;2130;2113;2106;8268;8237;8195;8118;5065;5046;5014;4938;3203;3191;3181;3180;2344;2372;2419;2460;
1203014;"Alwernia - miasto (4)";3459;3425;3435;3424;598;578;580;586;2332;2310;2298;2267;1420;1409;1403;1371;912;901;895;896;529;537;557;571;
1203015;"Alwernia - obszar wiejski (5)";9334;9314;9292;9260;1583;1552;1533;1520;5936;5927;5897;5851;3645;3637;3611;3567;2291;2290;2286;2284;1815;1835;1862;1889;
1203022;"Babice (2)";9007;9028;9056;9073;1621;1587;1566;1543;5746;5773;5777;5772;3536;3549;3548;3527;2210;2224;2229;2245;1640;1668;1713;1758;
1203033;"Chrzanów (3)";48595;48352;48132;47853;7598;7493;7421;7364;31018;30583;30105;29562;18416;18252;18042;17782;12602;12331;12063;11780;9979;10276;10606;10927;
1203034;"Chrzanów - miasto (4)";38420;38117;37898;37628;5974;5849;5816;5748;24577;24140;23650;23177;14553;14386;14143;13929;10024;9754;9507;9248;7869;8128;8432;8703;
1203035;"Chrzanów - obszar wiejski (5)";10175;10235;10234;10225;1624;1644;1605;1616;6441;6443;6455;6385;3863;3866;3899;3853;2578;2577;2556;2532;2110;2148;2174;2224;
1203043;"Libiąż (3)";22802;22768;22667;22649;4002;3979;3922;3921;14983;14828;14626;14446;9182;9119;9022;8935;5801;5709;5604;5511;3817;3961;4119;4282;
1203044;"Libiąż - miasto (4)";17374;17355;17284;17272;3000;2996;2968;2979;11580;11430;11255;11083;7030;6979;6909;6821;4550;4451;4346;4262;2794;2929;3061;3210;
1203045;"Libiąż - obszar wiejski (5)";5428;5413;5383;5377;1002;983;954;942;3403;3398;3371;3363;2152;2140;2113;2114;1251;1258;1258;1249;1023;1032;1058;1072;
1203053;"Trzebinia (3)";34447;34414;34263;34204;5724;5714;5660;5654;22130;21965;21715;21512;13230;13135;12975;12870;8900;8830;8740;8642;6593;6735;6888;7038;
1203054;"Trzebinia - miasto (4)";20309;20302;20127;20048;3360;3382;3332;3355;13126;12996;12770;12590;7780;7727;7592;7495;5346;5269;5178;5095;3823;3924;4025;4103;
1203055;"Trzebinia - obszar wiejski (5)";14138;14112;14136;14156;2364;2332;2328;2299;9004;8969;8945;8922;5450;5408;5383;5375;3554;3561;3562;3547;2770;2811;2863;2935;
1204012;"Bolesław (2)";2794;2806;2778;2752;454;447;429;428;1798;1817;1814;1801;1132;1129;1126;1109;666;688;688;692;542;542;535;523;
1204023;"Dąbrowa Tarnowska (3)";21087;21062;21135;21138;4197;4097;4049;4008;13671;13649;13640;13572;8987;8903;8894;8814;4684;4746;4746;4758;3219;3316;3446;3558;
1204024;"Dąbrowa Tarnowska - miasto (4)";11861;11846;11881;11891;2162;2124;2094;2112;7881;7820;7786;7695;5085;4992;4995;4937;2796;2828;2791;2758;1818;1902;2001;2084;
1204025;"Dąbrowa Tarnowska - obszar wiejski (5)";9226;9216;9254;9247;2035;1973;1955;1896;5790;5829;5854;5877;3902;3911;3899;3877;1888;1918;1955;2000;1401;1414;1445;1474;
1204032;"Gręboszów (2)";3457;3471;3458;3405;472;454;437;420;2275;2319;2319;2276;1383;1403;1399;1360;892;916;920;916;710;698;702;709;
1204042;"Mędrzechów (2)";3544;3525;3521;3544;653;616;601;590;2213;2226;2226;2262;1449;1447;1440;1457;764;779;786;805;678;683;694;692;
1204052;"Olesno (2)";7905;7914;7888;7908;1579;1516;1473;1456;5112;5155;5149;5157;3347;3387;3363;3363;1765;1768;1786;1794;1214;1243;1266;1295;
1204062;"Radgoszcz (2)";7380;7403;7393;7417;1668;1617;1561;1531;4555;4603;4648;4691;3073;3084;3098;3124;1482;1519;1550;1567;1157;1183;1184;1195;
1204073;"Szczucin (3)";13325;13332;13298;13210;2569;2498;2443;2398;8572;8614;8596;8528;5680;5704;5682;5597;2892;2910;2914;2931;2184;2220;2259;2284;
1204074;"Szczucin - miasto (4)";4175;4173;4189;4163;785;762;751;731;2776;2763;2759;2738;1810;1802;1805;1770;966;961;954;968;614;648;679;694;
1204075;"Szczucin - obszar wiejski (5)";9150;9159;9109;9047;1784;1736;1692;1667;5796;5851;5837;5790;3870;3902;3877;3827;1926;1949;1960;1963;1570;1572;1580;1590;
1205011;"Gorlice (1)";28555;28415;28255;28059;4826;4781;4689;4625;18405;18073;17791;17422;11053;10947;10822;10633;7352;7126;6969;6789;5324;5561;5775;6012;
1205023;"Biecz (3)";17052;17012;17000;16969;3424;3343;3363;3284;10678;10669;10562;10546;6786;6758;6662;6680;3892;3911;3900;3866;2950;3000;3075;3139;
1205024;"Biecz - miasto (4)";4704;4705;4728;4663;825;819;844;801;3050;3022;2985;2949;1837;1829;1824;1812;1213;1193;1161;1137;829;864;899;913;
1205025;"Biecz - obszar wiejski (5)";12348;12307;12272;12306;2599;2524;2519;2483;7628;7647;7577;7597;4949;4929;4838;4868;2679;2718;2739;2729;2121;2136;2176;2226;
1205033;"Bobowa (3)";9564;9563;9613;9707;2452;2435;2423;2408;5821;5816;5841;5919;3913;3886;3884;3948;1908;1930;1957;1971;1291;1312;1349;1380;
1205034;"Bobowa - miasto (4)";2996;3005;3006;3077;731;730;717;720;1882;1876;1863;1928;1238;1223;1213;1255;644;653;650;673;383;399;426;429;
1205035;"Bobowa - obszar wiejski (5)";6568;6558;6607;6630;1721;1705;1706;1688;3939;3940;3978;3991;2675;2663;2671;2693;1264;1277;1307;1298;908;913;923;951;
1205042;"Gorlice (2)";17045;17155;17145;17153;3520;3490;3407;3319;10686;10791;10828;10889;6868;6882;6843;6817;3818;3909;3985;4072;2839;2874;2910;2945;
1205052;"Lipinki (2)";6802;6791;6784;6780;1365;1327;1277;1256;4255;4279;4306;4287;2712;2735;2765;2770;1543;1544;1541;1517;1182;1185;1201;1237;
1205062;"Łużna (2)";8387;8362;8363;8400;1872;1816;1818;1806;5219;5243;5245;5266;3434;3438;3381;3375;1785;1805;1864;1891;1296;1303;1300;1328;
1205072;"Moszczenica (2)";4885;4867;4884;4897;1110;1093;1085;1092;2988;2997;3020;3035;1953;1937;1952;1947;1035;1060;1068;1088;787;777;779;770;
1205082;"Ropa (2)";5335;5365;5374;5369;1323;1316;1292;1286;3248;3265;3295;3285;2211;2223;2232;2208;1037;1042;1063;1077;764;784;787;798;
1205092;"Sękowa (2)";4921;4960;5009;5001;1016;1006;1017;984;3087;3121;3122;3132;1965;1979;1995;2003;1122;1142;1127;1129;818;833;870;885;
1205102;"Uście Gorlickie (2)";6719;6711;6754;6805;1610;1562;1544;1557;4212;4245;4259;4276;2808;2820;2820;2846;1404;1425;1439;1430;897;904;951;972;
1206012;"Czernichów (2)";13887;13984;14143;14316;2829;2837;2888;2924;8959;8984;9042;9123;5744;5772;5769;5837;3215;3212;3273;3286;2099;2163;2213;2269;
1206022;"Igołomia-Wawrzeńczyce (2)";7751;7724;7710;7714;1554;1502;1477;1468;4926;4912;4904;4866;3140;3164;3171;3147;1786;1748;1733;1719;1271;1310;1329;1380;
1206032;"Iwanowice (2)";8742;8837;8924;8970;1836;1848;1846;1856;5476;5495;5555;5554;3546;3571;3621;3609;1930;1924;1934;1945;1430;1494;1523;1560;
1206042;"Jerzmanowice-Przeginia (2)";10683;10743;10807;10842;2173;2102;2077;2067;6669;6743;6769;6784;4331;4374;4389;4392;2338;2369;2380;2392;1841;1898;1961;1991;
1206052;"Kocmyrzów-Luborzyca (2)";14535;14605;14769;14942;2936;2932;2900;2929;9367;9380;9490;9554;6074;6083;6149;6189;3293;3297;3341;3365;2232;2293;2379;2459;
1206063;"Krzeszowice (3)";32474;32492;32451;32394;5795;5776;5695;5656;20431;20302;20160;19988;12571;12547;12470;12409;7860;7755;7690;7579;6248;6414;6596;6750;
1206064;"Krzeszowice - miasto (4)";10281;10268;10173;10143;1734;1754;1705;1715;6374;6270;6159;6065;3914;3866;3811;3789;2460;2404;2348;2276;2173;2244;2309;2363;
1206065;"Krzeszowice - obszar wiejski (5)";22193;22224;22278;22251;4061;4022;3990;3941;14057;14032;14001;13923;8657;8681;8659;8620;5400;5351;5342;5303;4075;4170;4287;4387;
1206072;"Liszki (2)";16465;16563;16717;16815;3408;3479;3472;3515;10778;10718;10775;10742;6903;6840;6878;6834;3875;3878;3897;3908;2279;2366;2470;2558;
1206082;"Michałowice (2)";9538;9721;9845;9981;2135;2130;2157;2155;6092;6210;6260;6326;3973;4056;4065;4085;2119;2154;2195;2241;1311;1381;1428;1500;
1206092;"Mogilany (2)";12912;13221;13360;13532;2901;2948;2913;2947;8206;8389;8452;8549;5379;5464;5503;5509;2827;2925;2949;3040;1805;1884;1995;2036;
1206103;"Skała (3)";10278;10354;10463;10477;2097;2110;2137;2106;6453;6469;6519;6517;4148;4178;4194;4200;2305;2291;2325;2317;1728;1775;1807;1854;
1206104;"Skała - miasto (4)";3744;3762;3800;3786;726;734;750;751;2397;2387;2399;2361;1546;1553;1556;1525;851;834;843;836;621;641;651;674;
1206105;"Skała - obszar wiejski (5)";6534;6592;6663;6691;1371;1376;1387;1355;4056;4082;4120;4156;2602;2625;2638;2675;1454;1457;1482;1481;1107;1134;1156;1180;
1206113;"Skawina (3)";43006;43088;43137;43184;8286;8174;8147;8169;27656;27573;27351;27129;17762;17703;17554;17383;9894;9870;9797;9746;7064;7341;7639;7886;
1206114;"Skawina - miasto (4)";24280;24260;24203;24194;4360;4291;4251;4247;15557;15417;15200;15004;9822;9733;9611;9508;5735;5684;5589;5496;4363;4552;4752;4943;
1206115;"Skawina - obszar wiejski (5)";18726;18828;18934;18990;3926;3883;3896;3922;12099;12156;12151;12125;7940;7970;7943;7875;4159;4186;4208;4250;2701;2789;2887;2943;
1206123;"Słomniki (3)";13791;13730;13680;13638;2572;2532;2501;2486;8798;8734;8670;8579;5597;5568;5514;5472;3201;3166;3156;3107;2421;2464;2509;2573;
1206124;"Słomniki - miasto (4)";4442;4423;4402;4355;793;768;754;747;2862;2851;2822;2754;1793;1794;1768;1743;1069;1057;1054;1011;787;804;826;854;
1206125;"Słomniki - obszar wiejski (5)";9349;9307;9278;9283;1779;1764;1747;1739;5936;5883;5848;5825;3804;3774;3746;3729;2132;2109;2102;2096;1634;1660;1683;1719;
1206132;"Sułoszowa (2)";5830;5805;5804;5836;1224;1206;1196;1171;3553;3522;3511;3542;2291;2272;2279;2315;1262;1250;1232;1227;1053;1077;1097;1123;
1206143;"Świątniki Górne (3)";9518;9633;9686;9774;2006;2010;2006;2006;6235;6305;6339;6345;4012;4067;4061;4068;2223;2238;2278;2277;1277;1318;1341;1423;
1206144;"Świątniki Górne - miasto (4)";2364;2394;2400;2395;481;483;477;475;1527;1547;1553;1541;964;966;952;946;563;581;601;595;356;364;370;379;
1206145;"Świątniki Górne - obszar wiejski (5)";7154;7239;7286;7379;1525;1527;1529;1531;4708;4758;4786;4804;3048;3101;3109;3122;1660;1657;1677;1682;921;954;971;1044;
1206152;"Wielka Wieś (2)";10754;10946;11058;11231;2256;2303;2318;2347;6926;7001;7044;7116;4415;4487;4522;4571;2511;2514;2522;2545;1572;1642;1696;1768;
1206162;"Zabierzów (2)";24798;25044;25311;25565;4593;4608;4744;4820;15851;15923;15915;15936;9864;9935;9911;9911;5987;5988;6004;6025;4354;4513;4652;4809;
1206172;"Zielonki (2)";19677;20159;20652;21279;4371;4521;4638;4849;12526;12734;12947;13231;8117;8284;8423;8588;4409;4450;4524;4643;2780;2904;3067;3199;
1207011;"Limanowa (1)";15132;15133;15078;15128;3134;3132;3106;3139;9561;9476;9389;9303;6197;6135;6085;6062;3364;3341;3304;3241;2437;2525;2583;2686;
1207021;"Mszana Dolna (1)";7876;7863;7890;7924;1768;1724;1697;1693;4810;4786;4811;4823;3189;3163;3165;3171;1621;1623;1646;1652;1298;1353;1382;1408;
1207032;"Dobra (2)";9726;9796;9855;9876;2215;2200;2197;2160;6052;6089;6127;6163;3959;3989;3996;4006;2093;2100;2131;2157;1459;1507;1531;1553;
1207042;"Jodłownik (2)";8383;8408;8434;8515;2009;1979;1972;1959;5097;5121;5134;5202;3397;3410;3407;3446;1700;1711;1727;1756;1277;1308;1328;1354;
1207052;"Kamienica (2)";7713;7750;7776;7803;1998;1955;1938;1885;4732;4784;4787;4858;3159;3213;3185;3216;1573;1571;1602;1642;983;1011;1051;1060;
1207062;"Laskowa (2)";7852;7940;7959;8024;2104;2119;2088;2071;4703;4763;4814;4869;3131;3165;3177;3221;1572;1598;1637;1648;1045;1058;1057;1084;
1207072;"Limanowa (2)";24329;24405;24661;24834;6162;6075;6065;6037;15040;15127;15371;15471;10159;10188;10296;10325;4881;4939;5075;5146;3127;3203;3225;3326;
1207082;"Łukowica (2)";9761;9785;9817;9857;2594;2538;2529;2526;5829;5861;5905;5940;3974;4007;4029;4017;1855;1854;1876;1923;1338;1386;1383;1391;
1207092;"Mszana Dolna (2)";17240;17334;17364;17452;4334;4253;4157;4118;10435;10597;10695;10770;7005;7091;7116;7125;3430;3506;3579;3645;2471;2484;2512;2564;
1207102;"Niedźwiedź (2)";7167;7189;7225;7257;1887;1841;1795;1773;4450;4490;4559;4602;3021;3059;3097;3104;1429;1431;1462;1498;830;858;871;882;
1207112;"Słopnice (2)";6404;6453;6514;6541;1937;1936;1925;1877;3741;3791;3859;3934;2638;2651;2653;2675;1103;1140;1206;1259;726;726;730;730;
1207122;"Tymbark (2)";6462;6489;6500;6488;1646;1640;1621;1592;3931;3935;3947;3944;2591;2583;2574;2563;1340;1352;1373;1381;885;914;932;952;
1208012;"Charsznica (2)";7692;7669;7603;7573;1379;1345;1310;1277;4677;4645;4593;4575;2933;2932;2903;2902;1744;1713;1690;1673;1636;1679;1700;1721;
1208022;"Gołcza (2)";6219;6208;6203;6153;1075;1062;1061;1070;3908;3909;3889;3851;2405;2438;2434;2412;1503;1471;1455;1439;1236;1237;1253;1232;
1208032;"Kozłów (2)";4756;4734;4724;4715;841;816;808;787;2897;2904;2889;2881;1800;1818;1805;1822;1097;1086;1084;1059;1018;1014;1027;1047;
1208042;"Książ Wielki (2)";5286;5258;5211;5211;943;928;901;896;3163;3141;3119;3114;1912;1897;1876;1888;1251;1244;1243;1226;1180;1189;1191;1201;
1208053;"Miechów (3)";19940;19911;19934;19832;3488;3426;3432;3369;12407;12313;12206;12066;7687;7685;7643;7549;4720;4628;4563;4517;4045;4172;4296;4397;
1208054;"Miechów - miasto (4)";11845;11832;11830;11737;1952;1934;1934;1872;7466;7382;7296;7179;4530;4487;4454;4382;2936;2895;2842;2797;2427;2516;2600;2686;
1208055;"Miechów - obszar wiejski (5)";8095;8079;8104;8095;1536;1492;1498;1497;4941;4931;4910;4887;3157;3198;3189;3167;1784;1733;1721;1720;1618;1656;1696;1711;
1208062;"Racławice (2)";2485;2487;2462;2456;444;433;416;420;1512;1514;1505;1490;920;927;921;933;592;587;584;557;529;540;541;546;
1208072;"Słaboszów (2)";3731;3699;3687;3652;712;669;648;649;2217;2199;2194;2151;1318;1322;1335;1311;899;877;859;840;802;831;845;852;
1209013;"Dobczyce (3)";14998;15114;15114;15168;3299;3272;3207;3201;9781;9861;9861;9850;6451;6482;6489;6466;3330;3379;3372;3384;1918;1981;2046;2117;
1209014;"Dobczyce - miasto (4)";6417;6457;6449;6442;1315;1317;1286;1281;4288;4290;4265;4229;2799;2803;2795;2781;1489;1487;1470;1448;814;850;898;932;
1209015;"Dobczyce - obszar wiejski (5)";8581;8657;8665;8726;1984;1955;1921;1920;5493;5571;5596;5621;3652;3679;3694;3685;1841;1892;1902;1936;1104;1131;1148;1185;
1209022;"Lubień (2)";9861;9891;9938;10009;2376;2339;2341;2329;6098;6131;6143;6176;4103;4112;4079;4123;1995;2019;2064;2053;1387;1421;1454;1504;
1209033;"Myślenice (3)";42828;43106;43248;43493;9112;9096;9077;9125;27253;27317;27301;27285;17772;17784;17725;17651;9481;9533;9576;9634;6463;6693;6870;7083;
1209034;"Myślenice - miasto (4)";18383;18365;18346;18372;3506;3483;3490;3516;11456;11341;11237;11139;7370;7293;7197;7101;4086;4048;4040;4038;3421;3541;3619;3717;
1209035;"Myślenice - obszar wiejski (5)";24445;24741;24902;25121;5606;5613;5587;5609;15797;15976;16064;16146;10402;10491;10528;10550;5395;5485;5536;5596;3042;3152;3251;3366;
1209042;"Pcim (2)";10845;10877;10969;10982;2552;2502;2474;2458;6765;6819;6876;6869;4433;4435;4472;4456;2332;2384;2404;2413;1528;1556;1619;1655;
1209052;"Raciechowice (2)";6117;6197;6208;6231;1280;1285;1267;1272;3890;3946;3967;3975;2549;2580;2589;2608;1341;1366;1378;1367;947;966;974;984;
1209062;"Siepraw (2)";8390;8450;8566;8635;1871;1861;1881;1874;5388;5433;5494;5513;3505;3523;3567;3596;1883;1910;1927;1917;1131;1156;1191;1248;
1209073;"Sułkowice (3)";14552;14577;14650;14663;3275;3192;3189;3167;9386;9421;9419;9393;6130;6147;6151;6131;3256;3274;3268;3262;1891;1964;2042;2103;
1209074;"Sułkowice - miasto (4)";6537;6520;6537;6539;1455;1402;1387;1370;4212;4213;4213;4206;2769;2769;2763;2743;1443;1444;1450;1463;870;905;937;963;
1209075;"Sułkowice - obszar wiejski (5)";8015;8057;8113;8124;1820;1790;1802;1797;5174;5208;5206;5187;3361;3378;3388;3388;1813;1830;1818;1799;1021;1059;1105;1140;
1209082;"Tokarnia (2)";8579;8561;8559;8581;2124;2069;2028;1996;5385;5396;5430;5462;3605;3602;3597;3610;1780;1794;1833;1852;1070;1096;1101;1123;
1209092;"Wiśniowa (2)";7157;7218;7230;7258;1653;1644;1647;1659;4491;4517;4520;4516;2955;2987;2983;2987;1536;1530;1537;1529;1013;1057;1063;1083;
1210011;"Grybów (1)";6175;6086;6063;6051;1273;1237;1219;1231;3837;3787;3763;3732;2433;2389;2384;2354;1404;1398;1379;1378;1065;1062;1081;1088;
1210022;"Chełmiec (2)";26897;27125;27386;27689;6678;6608;6536;6470;17046;17262;17493;17708;11514;11560;11647;11748;5532;5702;5846;5960;3173;3255;3357;3511;
1210032;"Gródek nad Dunajcem (2)";9164;9205;9194;9216;2336;2295;2252;2207;5522;5571;5588;5625;3732;3772;3726;3723;1790;1799;1862;1902;1306;1339;1354;1384;
1210042;"Grybów (2)";24216;24402;24617;24825;6437;6366;6315;6287;14603;14803;15005;15156;9914;9989;10098;10198;4689;4814;4907;4958;3176;3233;3297;3382;
1210052;"Kamionka Wielka (2)";9929;10026;10100;10140;2643;2625;2581;2546;6062;6166;6255;6312;4145;4181;4220;4218;1917;1985;2035;2094;1224;1235;1264;1282;
1210062;"Korzenna (2)";14023;14128;14197;14242;3556;3508;3473;3417;8622;8750;8827;8912;5907;5972;5996;6008;2715;2778;2831;2904;1845;1870;1897;1913;
1210073;"Krynica-Zdrój (3)";16980;16991;16862;16858;3243;3149;3101;3079;10669;10677;10526;10436;6726;6735;6644;6597;3943;3942;3882;3839;3068;3165;3235;3343;
1210074;"Krynica-Zdrój - miasto (4)";11191;11165;10992;10933;1754;1701;1651;1642;7019;6976;6813;6683;4250;4227;4140;4065;2769;2749;2673;2618;2418;2488;2528;2608;
1210075;"Krynica-Zdrój - obszar wiejski (5)";5789;5826;5870;5925;1489;1448;1450;1437;3650;3701;3713;3753;2476;2508;2504;2532;1174;1193;1209;1221;650;677;707;735;
1210082;"Łabowa (2)";5711;5763;5831;5921;1560;1558;1583;1588;3538;3574;3584;3651;2467;2471;2472;2501;1071;1103;1112;1150;613;631;664;682;
1210092;"Łącko (2)";15930;16051;16116;16187;4086;4075;4032;4025;9750;9846;9928;9985;6613;6668;6694;6684;3137;3178;3234;3301;2094;2130;2156;2177;
1210102;"Łososina Dolna (2)";10603;10662;10702;10776;2759;2748;2702;2688;6411;6446;6505;6568;4438;4473;4470;4465;1973;1973;2035;2103;1433;1468;1495;1520;
1210113;"Muszyna (3)";11766;11730;11693;11676;2626;2540;2475;2433;7404;7386;7340;7293;4832;4816;4786;4744;2572;2570;2554;2549;1736;1804;1878;1950;
1210114;"Muszyna - miasto (4)";5115;5069;5028;5020;977;939;900;888;3229;3200;3152;3121;1992;1972;1954;1928;1237;1228;1198;1193;909;930;976;1011;
1210115;"Muszyna - obszar wiejski (5)";6651;6661;6665;6656;1649;1601;1575;1545;4175;4186;4188;4172;2840;2844;2832;2816;1335;1342;1356;1356;827;874;902;939;
1210122;"Nawojowa (2)";8259;8372;8424;8489;2191;2208;2173;2144;5080;5145;5203;5257;3432;3463;3465;3479;1648;1682;1738;1778;988;1019;1048;1088;
1210133;"Piwniczna-Zdrój (3)";10688;10683;10667;10673;2359;2322;2274;2241;6766;6783;6781;6773;4385;4390;4380;4365;2381;2393;2401;2408;1563;1578;1612;1659;
1210134;"Piwniczna-Zdrój - miasto (4)";5993;5981;5967;5943;1227;1199;1178;1168;3844;3852;3842;3806;2459;2449;2434;2397;1385;1403;1408;1409;922;930;947;969;
1210135;"Piwniczna-Zdrój - obszar wiejski (5)";4695;4702;4700;4730;1132;1123;1096;1073;2922;2931;2939;2967;1926;1941;1946;1968;996;990;993;999;641;648;665;690;
1210142;"Podegrodzie (2)";12487;12589;12729;12849;3295;3262;3278;3278;7635;7737;7838;7922;5286;5367;5398;5416;2349;2370;2440;2506;1557;1590;1613;1649;
1210152;"Rytro (2)";3841;3842;3853;3857;870;865;845;833;2411;2401;2403;2399;1578;1565;1557;1556;833;836;846;843;560;576;605;625;
1210163;"Stary Sącz (3)";23319;23390;23396;23445;5379;5319;5184;5082;14759;14794;14856;14893;9738;9725;9708;9704;5021;5069;5148;5189;3181;3277;3356;3470;
1210164;"Stary Sącz - miasto (4)";9121;9107;9040;9053;1824;1816;1743;1711;5844;5790;5768;5751;3753;3712;3676;3673;2091;2078;2092;2078;1453;1501;1529;1591;
1210165;"Stary Sącz - obszar wiejski (5)";14198;14283;14356;14392;3555;3503;3441;3371;8915;9004;9088;9142;5985;6013;6032;6031;2930;2991;3056;3111;1728;1776;1827;1879;
1211011;"Nowy Targ (1)";33804;33672;33598;33510;6458;6328;6201;6115;21471;21229;21099;20879;13948;13793;13651;13484;7523;7436;7448;7395;5875;6115;6298;6516;
1211023;"Szczawnica (3)";7431;7472;7445;7402;1460;1430;1432;1392;4655;4696;4626;4601;2933;2978;2912;2911;1722;1718;1714;1690;1316;1346;1387;1409;
1211024;"Szczawnica - miasto (4)";5942;5983;5972;5923;1109;1092;1093;1066;3695;3727;3671;3637;2299;2336;2289;2271;1396;1391;1382;1366;1138;1164;1208;1220;
1211025;"Szczawnica - obszar wiejski (5)";1489;1489;1473;1479;351;338;339;326;960;969;955;964;634;642;623;640;326;327;332;324;178;182;179;189;
1211032;"Czarny Dunajec (2)";21985;22065;22163;22267;4692;4599;4542;4489;14001;14071;14124;14164;9295;9293;9281;9279;4706;4778;4843;4885;3292;3395;3497;3614;
1211042;"Czorsztyn (2)";7496;7525;7573;7577;1680;1646;1638;1595;4730;4757;4780;4810;3132;3141;3148;3159;1598;1616;1632;1651;1086;1122;1155;1172;
1211052;"Jabłonka (2)";17906;18021;18144;18268;4581;4508;4470;4417;10995;11160;11295;11400;7555;7644;7647;7700;3440;3516;3648;3700;2330;2353;2379;2451;
1211062;"Krościenko nad Dunajcem (2)";6702;6722;6721;6755;1463;1457;1445;1454;4132;4124;4101;4085;2634;2624;2613;2617;1498;1500;1488;1468;1107;1141;1175;1216;
1211072;"Lipnica Wielka (2)";5918;5944;5961;5981;1514;1499;1473;1459;3672;3693;3729;3728;2546;2560;2572;2554;1126;1133;1157;1174;732;752;759;794;
1211082;"Łapsze Niżne (2)";9149;9182;9205;9237;2008;1956;1929;1918;5799;5827;5863;5877;3855;3856;3865;3849;1944;1971;1998;2028;1342;1399;1413;1442;
1211092;"Nowy Targ (2)";23375;23458;23606;23717;5372;5297;5214;5102;14761;14854;14988;15098;9870;9865;9902;9947;4891;4989;5086;5151;3242;3307;3404;3517;
1211102;"Ochotnica Dolna (2)";8347;8396;8422;8470;2142;2084;2054;2021;5083;5193;5224;5286;3364;3429;3403;3424;1719;1764;1821;1862;1122;1119;1144;1163;
1211112;"Raba Wyżna (2)";14478;14517;14557;14605;3319;3267;3217;3122;9141;9193;9231;9283;6115;6099;6080;6094;3026;3094;3151;3189;2018;2057;2109;2200;
1211123;"Rabka-Zdrój (3)";17492;17468;17416;17322;3384;3296;3174;3104;10843;10821;10802;10731;6876;6815;6754;6716;3967;4006;4048;4015;3265;3351;3440;3487;
1211124;"Rabka-Zdrój - miasto (4)";13212;13154;13082;12985;2446;2376;2253;2191;8087;8030;8003;7933;5034;4974;4925;4880;3053;3056;3078;3053;2679;2748;2826;2861;
1211125;"Rabka-Zdrój - obszar wiejski (5)";4280;4314;4334;4337;938;920;921;913;2756;2791;2799;2798;1842;1841;1829;1836;914;950;970;962;586;603;614;626;
1211132;"Spytkowice (2)";4402;4372;4443;4491;1123;1070;1066;1056;2700;2717;2771;2801;1805;1821;1855;1863;895;896;916;938;579;585;606;634;
1211142;"Szaflary (2)";10783;10809;10874;10915;2460;2395;2356;2300;6792;6857;6899;6952;4533;4574;4559;4570;2259;2283;2340;2382;1531;1557;1619;1663;
1212011;"Bukowno (1)";10488;10411;10336;10341;1579;1549;1516;1496;6752;6663;6563;6492;3912;3827;3776;3770;2840;2836;2787;2722;2157;2199;2257;2353;
1212032;"Bolesław (2)";7839;7817;7810;7802;1311;1302;1267;1231;4928;4867;4838;4797;2953;2956;2972;2972;1975;1911;1866;1825;1600;1648;1705;1774;
1212042;"Klucze (2)";15306;15306;15281;15174;2673;2647;2593;2567;9672;9605;9514;9365;5919;5920;5858;5782;3753;3685;3656;3583;2961;3054;3174;3242;
1212053;"Olkusz (3)";50233;50016;49800;49515;8465;8342;8232;8140;32960;32360;31845;31217;19797;19644;19524;19286;13163;12716;12321;11931;8808;9314;9723;10158;
1212054;"Olkusz - miasto (4)";36993;36724;36477;36213;6018;5908;5845;5796;24588;24016;23460;22856;14569;14425;14288;14060;10019;9591;9172;8796;6387;6800;7172;7561;
1212055;"Olkusz - obszar wiejski (5)";13240;13292;13323;13302;2447;2434;2387;2344;8372;8344;8385;8361;5228;5219;5236;5226;3144;3125;3149;3135;2421;2514;2551;2597;
1212062;"Trzyciąż (2)";7115;7104;7061;7085;1416;1405;1357;1329;4286;4276;4287;4337;2751;2749;2728;2753;1535;1527;1559;1584;1413;1423;1417;1419;
1212073;"Wolbrom (3)";23477;23419;23362;23231;4230;4171;4134;4031;14763;14641;14581;14438;9275;9199;9134;9053;5488;5442;5447;5385;4484;4607;4647;4762;
1212074;"Wolbrom - miasto (4)";8926;8874;8823;8773;1460;1441;1413;1383;5795;5681;5627;5544;3542;3479;3442;3404;2253;2202;2185;2140;1671;1752;1783;1846;
1212075;"Wolbrom - obszar wiejski (5)";14551;14545;14539;14458;2770;2730;2721;2648;8968;8960;8954;8894;5733;5720;5692;5649;3235;3240;3262;3245;2813;2855;2864;2916;
1213011;"Oświęcim (1)";39893;39664;39444;39215;6419;6383;6277;6248;24424;24107;23766;23390;14796;14663;14501;14339;9628;9444;9265;9051;9050;9174;9401;9577;
1213023;"Brzeszcze (3)";21675;21710;21587;21525;3773;3777;3760;3773;14134;14034;13817;13639;8460;8424;8324;8234;5674;5610;5493;5405;3768;3899;4010;4113;
1213024;"Brzeszcze - miasto (4)";11691;11637;11560;11513;1929;1895;1893;1922;7432;7349;7226;7109;4443;4404;4347;4268;2989;2945;2879;2841;2330;2393;2441;2482;
1213025;"Brzeszcze - obszar wiejski (5)";9984;10073;10027;10012;1844;1882;1867;1851;6702;6685;6591;6530;4017;4020;3977;3966;2685;2665;2614;2564;1438;1506;1569;1631;
1213033;"Chełmek (3)";13086;13027;13084;13106;2237;2165;2172;2171;8429;8377;8346;8302;5260;5211;5223;5194;3169;3166;3123;3108;2420;2485;2566;2633;
1213034;"Chełmek - miasto (4)";9216;9168;9198;9170;1561;1521;1522;1522;5922;5872;5831;5767;3711;3667;3680;3630;2211;2205;2151;2137;1733;1775;1845;1881;
1213035;"Chełmek - obszar wiejski (5)";3870;3859;3886;3936;676;644;650;649;2507;2505;2515;2535;1549;1544;1543;1564;958;961;972;971;687;710;721;752;
1213043;"Kęty (3)";34260;34342;34357;34333;6326;6352;6286;6283;22116;21978;21821;21604;13882;13745;13657;13510;8234;8233;8164;8094;5818;6012;6250;6446;
1213044;"Kęty - miasto (4)";19151;19104;19062;19003;3286;3291;3270;3260;12465;12260;12051;11857;7654;7527;7441;7347;4811;4733;4610;4510;3400;3553;3741;3886;
1213045;"Kęty - obszar wiejski (5)";15109;15238;15295;15330;3040;3061;3016;3023;9651;9718;9770;9747;6228;6218;6216;6163;3423;3500;3554;3584;2418;2459;2509;2560;
1213052;"Osiek (2)";8064;8099;8129;8179;1652;1645;1633;1634;5115;5150;5155;5176;3250;3255;3254;3280;1865;1895;1901;1896;1297;1304;1341;1369;
1213062;"Oświęcim (2)";17750;17874;18044;18126;3367;3361;3379;3402;11386;11448;11526;11500;7002;6993;7010;7007;4384;4455;4516;4493;2997;3065;3139;3224;
1213072;"Polanka Wielka (2)";4248;4268;4269;4276;857;850;854;833;2681;2706;2694;2718;1776;1780;1743;1747;905;926;951;971;710;712;721;725;
1213082;"Przeciszów (2)";6776;6757;6734;6733;1304;1298;1272;1264;4263;4234;4206;4195;2669;2636;2603;2592;1594;1598;1603;1603;1209;1225;1256;1274;
1213093;"Zator (3)";9288;9299;9329;9326;1771;1740;1733;1699;5966;5990;5993;5977;3760;3751;3736;3721;2206;2239;2257;2256;1551;1569;1603;1650;
1213094;"Zator - miasto (4)";3694;3683;3700;3692;650;630;630;613;2387;2387;2383;2367;1436;1441;1441;1442;951;946;942;925;657;666;687;712;
1213095;"Zator - obszar wiejski (5)";5594;5616;5629;5634;1121;1110;1103;1086;3579;3603;3610;3610;2324;2310;2295;2279;1255;1293;1315;1331;894;903;916;938;
1214012;"Koniusza (2)";8823;8887;8916;8870;1759;1783;1741;1722;5576;5565;5589;5538;3529;3529;3552;3527;2047;2036;2037;2011;1488;1539;1586;1610;
1214022;"Koszyce (2)";5711;5681;5651;5611;974;950;935;914;3576;3565;3541;3519;2236;2212;2203;2176;1340;1353;1338;1343;1161;1166;1175;1178;
1214033;"Nowe Brzesko (3)";5830;5812;5812;5763;1081;1048;1036;1016;3721;3697;3686;3646;2345;2332;2336;2317;1376;1365;1350;1329;1028;1067;1090;1101;
1214034;"Nowe Brzesko - miasto (4)";1663;1672;1667;1660;292;290;286;285;1099;1091;1078;1064;687;682;672;661;412;409;406;403;272;291;303;311;
1214035;"Nowe Brzesko - obszar wiejski (5)";4167;4140;4145;4103;789;758;750;731;2622;2606;2608;2582;1658;1650;1664;1656;964;956;944;926;756;776;787;790;
1214042;"Pałecznica (2)";3656;3655;3682;3670;747;730;735;736;2220;2226;2219;2202;1439;1447;1443;1434;781;779;776;768;689;699;728;732;
1214053;"Proszowice (3)";16464;16372;16377;16363;2990;2880;2853;2783;10441;10392;10325;10311;6642;6637;6622;6591;3799;3755;3703;3720;3033;3100;3199;3269;
1214054;"Proszowice - miasto (4)";6242;6184;6158;6132;1084;1023;1015;997;3961;3928;3856;3816;2518;2503;2465;2432;1443;1425;1391;1384;1197;1233;1287;1319;
1214055;"Proszowice - obszar wiejski (5)";10222;10188;10219;10231;1906;1857;1838;1786;6480;6464;6469;6495;4124;4134;4157;4159;2356;2330;2312;2336;1836;1867;1912;1950;
1214062;"Radziemice (2)";3461;3457;3454;3439;693;667;648;643;2099;2099;2097;2080;1361;1370;1380;1346;738;729;717;734;669;691;709;716;
1215011;"Jordanów (1)";5286;5274;5305;5324;1015;998;1012;1023;3448;3434;3416;3397;2170;2157;2149;2150;1278;1277;1267;1247;823;842;877;904;
1215021;"Sucha Beskidzka (1)";9499;9485;9414;9432;1781;1742;1734;1733;6027;5987;5857;5841;3704;3703;3645;3653;2323;2284;2212;2188;1691;1756;1823;1858;
1215032;"Budzów (2)";8697;8732;8770;8814;2145;2115;2078;2073;5315;5361;5419;5460;3552;3570;3599;3603;1763;1791;1820;1857;1237;1256;1273;1281;
1215042;"Bystra-Sidzina (2)";6768;6759;6778;6786;1703;1613;1578;1536;4085;4155;4204;4227;2782;2830;2836;2846;1303;1325;1368;1381;980;991;996;1023;
1215052;"Jordanów (2)";10870;10932;10987;11011;2566;2494;2453;2409;6703;6794;6845;6848;4478;4541;4589;4601;2225;2253;2256;2247;1601;1644;1689;1754;
1215063;"Maków Podhalański (3)";16355;16403;16361;16351;3351;3302;3217;3217;10041;10088;10062;10009;6423;6447;6409;6353;3618;3641;3653;3656;2963;3013;3082;3125;
1215064;"Maków Podhalański - miasto (4)";6046;6037;5980;5990;1098;1070;1025;1031;3670;3668;3627;3599;2283;2284;2252;2235;1387;1384;1375;1364;1278;1299;1328;1360;
1215065;"Maków Podhalański - obszar wiejski (5)";10309;10366;10381;10361;2253;2232;2192;2186;6371;6420;6435;6410;4140;4163;4157;4118;2231;2257;2278;2292;1685;1714;1754;1765;
1215072;"Stryszawa (2)";11760;11772;11815;11777;2307;2269;2245;2214;7460;7482;7496;7467;4704;4715;4737;4721;2756;2767;2759;2746;1993;2021;2074;2096;
1215082;"Zawoja (2)";9085;9089;9072;9058;2036;1986;1915;1897;5577;5594;5603;5567;3555;3561;3553;3543;2022;2033;2050;2024;1472;1509;1554;1594;
1215092;"Zembrzyce (2)";5641;5665;5638;5622;1114;1101;1097;1045;3513;3524;3501;3538;2240;2269;2245;2256;1273;1255;1256;1282;1014;1040;1040;1039;
1216013;"Ciężkowice (3)";11233;11277;11304;11245;2488;2428;2366;2300;6952;7012;7053;7040;4680;4726;4716;4685;2272;2286;2337;2355;1793;1837;1885;1905;
1216014;"Ciężkowice - miasto (4)";2480;2483;2496;2485;497;478;468;459;1575;1572;1584;1569;1025;1027;1039;1037;550;545;545;532;408;433;444;457;
1216015;"Ciężkowice - obszar wiejski (5)";8753;8794;8808;8760;1991;1950;1898;1841;5377;5440;5469;5471;3655;3699;3677;3648;1722;1741;1792;1823;1385;1404;1441;1448;
1216022;"Gromnik (2)";8739;8770;8782;8807;1992;1993;1964;1939;5479;5496;5516;5528;3703;3683;3707;3707;1776;1813;1809;1821;1268;1281;1302;1340;
1216032;"Lisia Góra (2)";14683;14762;14866;14975;3362;3313;3318;3288;9331;9416;9462;9557;6301;6344;6343;6370;3030;3072;3119;3187;1990;2033;2086;2130;
1216042;"Pleśna (2)";11859;11938;11924;11975;2628;2605;2522;2483;7432;7488;7515;7571;4944;4969;4938;4932;2488;2519;2577;2639;1799;1845;1887;1921;
1216053;"Radłów (3)";9738;9804;9775;9800;1844;1826;1764;1750;6297;6341;6338;6371;4068;4072;4057;4055;2229;2269;2281;2316;1597;1637;1673;1679;
1216054;"Radłów - miasto (4)";2739;2773;2766;2774;470;471;470;472;1830;1848;1825;1822;1150;1176;1164;1152;680;672;661;670;439;454;471;480;
1216055;"Radłów - obszar wiejski (5)";6999;7031;7009;7026;1374;1355;1294;1278;4467;4493;4513;4549;2918;2896;2893;2903;1549;1597;1620;1646;1158;1183;1202;1199;
1216063;"Ryglice (3)";11689;11753;11723;11708;2674;2630;2559;2497;7103;7199;7231;7280;4814;4854;4850;4861;2289;2345;2381;2419;1912;1924;1933;1931;
1216064;"Ryglice - miasto (4)";2880;2880;2870;2850;638;626;610;573;1753;1755;1758;1771;1139;1140;1136;1147;614;615;622;624;489;499;502;506;
1216065;"Ryglice - obszar wiejski (5)";8809;8873;8853;8858;2036;2004;1949;1924;5350;5444;5473;5509;3675;3714;3714;3714;1675;1730;1759;1795;1423;1425;1431;1425;
1216072;"Rzepiennik Strzyżewski (2)";6849;6811;6791;6764;1573;1518;1482;1459;4112;4128;4147;4149;2791;2782;2783;2757;1321;1346;1364;1392;1164;1165;1162;1156;
1216082;"Skrzyszów (2)";13776;13928;14008;14084;3030;3008;2957;2942;8831;8964;9033;9059;5823;5873;5886;5853;3008;3091;3147;3206;1915;1956;2018;2083;
1216092;"Tarnów (2)";24844;25052;25254;25557;5231;5157;5097;5093;15989;16128;16249;16390;10222;10246;10268;10359;5767;5882;5981;6031;3624;3767;3908;4074;
1216103;"Tuchów (3)";18140;18149;18169;18155;3908;3851;3784;3723;11287;11323;11391;11394;7469;7451;7454;7392;3818;3872;3937;4002;2945;2975;2994;3038;
1216104;"Tuchów - miasto (4)";6729;6720;6724;6709;1406;1387;1364;1349;4189;4172;4190;4176;2707;2689;2719;2691;1482;1483;1471;1485;1134;1161;1170;1184;
1216105;"Tuchów - obszar wiejski (5)";11411;11429;11445;11446;2502;2464;2420;2374;7098;7151;7201;7218;4762;4762;4735;4701;2336;2389;2466;2517;1811;1814;1824;1854;
1216112;"Wierzchosławice (2)";10653;10674;10701;10721;2141;2078;2049;2002;6738;6772;6791;6803;4345;4364;4359;4348;2393;2408;2432;2455;1774;1824;1861;1916;
1216122;"Wietrzychowice (2)";4043;4034;4019;3997;716;671;633;595;2552;2584;2588;2607;1595;1617;1607;1601;957;967;981;1006;775;779;798;795;
1216133;"Wojnicz (3)";13305;13312;13319;13394;2811;2787;2729;2692;8440;8454;8452;8521;5517;5482;5464;5463;2923;2972;2988;3058;2054;2071;2138;2181;
1216134;"Wojnicz - miasto (4)";3428;3406;3401;3383;690;695;678;644;2190;2152;2131;2134;1400;1373;1362;1362;790;779;769;772;548;559;592;605;
1216135;"Wojnicz - obszar wiejski (5)";9877;9906;9918;10011;2121;2092;2051;2048;6250;6302;6321;6387;4117;4109;4102;4101;2133;2193;2219;2286;1506;1512;1546;1576;
1216143;"Zakliczyn (3)";12397;12405;12410;12410;2732;2643;2585;2575;7716;7790;7803;7746;5164;5202;5206;5195;2552;2588;2597;2551;1949;1972;2022;2089;
1216144;"Zakliczyn - miasto (4)";1646;1665;1661;1665;318;315;306;307;1045;1048;1043;1026;661;659;667;656;384;389;376;370;283;302;312;332;
1216145;"Zakliczyn - obszar wiejski (5)";10751;10740;10749;10745;2414;2328;2279;2268;6671;6742;6760;6720;4503;4543;4539;4539;2168;2199;2221;2181;1666;1670;1710;1757;
1216153;"Żabno (3)";19064;18984;18982;19005;3642;3505;3461;3402;12265;12305;12310;12308;7887;7850;7787;7741;4378;4455;4523;4567;3157;3174;3211;3295;
1216154;"Żabno - miasto (4)";4277;4223;4214;4220;755;710;687;674;2789;2766;2749;2733;1764;1743;1726;1700;1025;1023;1023;1033;733;747;778;813;
1216155;"Żabno - obszar wiejski (5)";14787;14761;14768;14785;2887;2795;2774;2728;9476;9539;9561;9575;6123;6107;6061;6041;3353;3432;3500;3534;2424;2427;2433;2482;
1216162;"Szerzyny (2)";8050;8022;8058;8003;1721;1682;1652;1613;4915;4924;4989;4969;3249;3231;3264;3245;1666;1693;1725;1724;1414;1416;1417;1421;
1217011;"Zakopane (1)";27837;27721;27556;27442;4711;4637;4605;4552;17239;17067;16796;16602;10408;10328;10165;10076;6831;6739;6631;6526;5887;6017;6155;6288;
1217022;"Biały Dunajec (2)";7064;7096;7096;7112;1546;1541;1516;1496;4466;4476;4463;4459;2951;2950;2897;2890;1515;1526;1566;1569;1052;1079;1117;1157;
1217032;"Bukowina Tatrzańska (2)";13025;13070;13138;13198;2866;2835;2823;2798;8190;8223;8266;8282;5422;5398;5400;5379;2768;2825;2866;2903;1969;2012;2049;2118;
1217042;"Kościelisko (2)";8580;8621;8639;8659;1765;1735;1713;1704;5537;5550;5548;5546;3502;3512;3521;3517;2035;2038;2027;2029;1278;1336;1378;1409;
1217052;"Poronin (2)";11325;11339;11422;11473;2646;2603;2598;2581;7079;7084;7099;7149;4788;4785;4797;4826;2291;2299;2302;2323;1600;1652;1725;1743;
1218013;"Andrychów (3)";43894;43848;43825;43957;8774;8651;8619;8628;27831;27683;27409;27283;17725;17587;17382;17291;10106;10096;10027;9992;7289;7514;7797;8046;
1218014;"Andrychów - miasto (4)";21239;21111;20993;20940;3734;3704;3683;3672;13458;13211;12944;12738;8341;8184;8046;7977;5117;5027;4898;4761;4047;4196;4366;4530;
1218015;"Andrychów - obszar wiejski (5)";22655;22737;22832;23017;5040;4947;4936;4956;14373;14472;14465;14545;9384;9403;9336;9314;4989;5069;5129;5231;3242;3318;3431;3516;
1218022;"Brzeźnica (2)";10038;10093;10124;10188;2076;2072;2072;2094;6382;6407;6409;6429;4157;4166;4159;4159;2225;2241;2250;2270;1580;1614;1643;1665;
1218033;"Kalwaria Zebrzydowska (3)";19835;19864;19899;19897;4021;3989;3923;3869;12722;12707;12694;12665;8294;8262;8223;8167;4428;4445;4471;4498;3092;3168;3282;3363;
1218034;"Kalwaria Zebrzydowska - miasto (4)";4608;4593;4603;4601;866;869;858;863;2912;2883;2873;2844;1884;1856;1846;1829;1028;1027;1027;1015;830;841;872;894;
1218035;"Kalwaria Zebrzydowska - obszar wiejski (5)";15227;15271;15296;15296;3155;3120;3065;3006;9810;9824;9821;9821;6410;6406;6377;6338;3400;3418;3444;3483;2262;2327;2410;2469;
1218042;"Lanckorona (2)";6169;6165;6137;6148;1362;1339;1317;1328;3952;3957;3917;3886;2569;2545;2511;2483;1383;1412;1406;1403;855;869;903;934;
1218052;"Mucharz (2)";4026;4024;4023;4034;865;841;838;844;2532;2540;2529;2532;1618;1614;1593;1586;914;926;936;946;629;643;656;658;
1218062;"Spytkowice (2)";10135;10187;10212;10242;2080;2063;2054;2055;6521;6564;6565;6547;4252;4273;4241;4175;2269;2291;2324;2372;1534;1560;1593;1640;
1218072;"Stryszów (2)";6820;6819;6823;6824;1431;1406;1412;1379;4339;4349;4339;4338;2767;2775;2759;2769;1572;1574;1580;1569;1050;1064;1072;1107;
1218082;"Tomice (2)";7742;7798;7886;7930;1753;1748;1760;1746;4927;4949;4995;5009;3208;3218;3246;3280;1719;1731;1749;1729;1062;1101;1131;1175;
1218093;"Wadowice (3)";38068;38118;38172;38118;7458;7387;7309;7219;23965;23885;23780;23621;15182;15170;15131;15010;8783;8715;8649;8611;6645;6846;7083;7278;
1218094;"Wadowice - miasto (4)";19356;19309;19254;19179;3479;3454;3388;3367;12101;11905;11767;11568;7520;7440;7426;7309;4581;4465;4341;4259;3776;3950;4099;4244;
1218095;"Wadowice - obszar wiejski (5)";18712;18809;18918;18939;3979;3933;3921;3852;11864;11980;12013;12053;7662;7730;7705;7701;4202;4250;4308;4352;2869;2896;2984;3034;
1218102;"Wieprz (2)";12013;12067;12132;12200;2746;2709;2696;2672;7483;7538;7565;7612;4915;4936;4932;4954;2568;2602;2633;2658;1784;1820;1871;1916;
1219012;"Biskupice (2)";9479;9624;9744;9872;2076;2088;2113;2122;6030;6130;6186;6266;3932;3985;4033;4078;2098;2145;2153;2188;1373;1406;1445;1484;
1219022;"Gdów (2)";17377;17532;17665;17758;3995;3955;3909;3861;11038;11178;11307;11337;7357;7434;7490;7471;3681;3744;3817;3866;2344;2399;2449;2560;
1219032;"Kłaj (2)";10494;10559;10590;10567;2126;2116;2118;2097;6750;6765;6723;6676;4347;4371;4357;4307;2403;2394;2366;2369;1618;1678;1749;1794;
1219043;"Niepołomice (3)";25057;25607;26124;26633;5120;5246;5383;5527;16283;16558;16790;16987;10476;10735;10909;11087;5807;5823;5881;5900;3654;3803;3951;4119;
1219044;"Niepołomice - miasto (4)";10482;10822;11201;11573;2216;2320;2449;2587;6820;6970;7161;7303;4454;4601;4735;4880;2366;2369;2426;2423;1446;1532;1591;1683;
1219045;"Niepołomice - obszar wiejski (5)";14575;14785;14923;15060;2904;2926;2934;2940;9463;9588;9629;9684;6022;6134;6174;6207;3441;3454;3455;3477;2208;2271;2360;2436;
1219053;"Wieliczka (3)";54392;55231;55941;56704;11166;11319;11404;11635;34644;35006;35235;35371;22531;22820;22986;23107;12113;12186;12249;12264;8582;8906;9302;9698;
1219054;"Wieliczka - miasto (4)";20988;21318;21676;22086;3994;4073;4149;4334;13057;13203;13298;13366;8573;8685;8787;8835;4484;4518;4511;4531;3937;4042;4229;4386;
1219055;"Wieliczka - obszar wiejski (5)";33404;33913;34265;34618;7172;7246;7255;7301;21587;21803;21937;22005;13958;14135;14199;14272;7629;7668;7738;7733;4645;4864;5073;5312;
1261011;"Kraków (1)";758334;758992;761873;761069;117148;118177;119398;120953;485849;480990;478243;471743;316264;314713;314457;310393;169585;166277;163786;161350;155337;159825;164232;168373;
1262011;"Nowy Sącz (1)";84129;83943;83853;83903;16128;15984;15862;15710;53437;52877;52472;52066;33862;33608;33355;33160;19575;19269;19117;18906;14564;15082;15519;16127;
1263011;"Tarnów (1)";112952;112120;111376;110644;18393;18255;17902;17586;71851;70383;69207;68033;44289;43347;42672;41948;27562;27036;26535;26085;22708;23482;24267;25025;
1401013;"Białobrzegi (3)";10426;10375;10395;10407;2037;2035;2040;2040;6693;6559;6519;6448;4273;4210;4186;4156;2420;2349;2333;2292;1696;1781;1836;1919;
1401014;"Białobrzegi - miasto (4)";7191;7132;7110;7088;1316;1308;1309;1302;4628;4500;4427;4349;2906;2860;2811;2782;1722;1640;1616;1567;1247;1324;1374;1437;
1401015;"Białobrzegi - obszar wiejski (5)";3235;3243;3285;3319;721;727;731;738;2065;2059;2092;2099;1367;1350;1375;1374;698;709;717;725;449;457;462;482;
1401022;"Promna (2)";5648;5622;5588;5562;1122;1111;1118;1106;3507;3492;3449;3445;2206;2192;2154;2151;1301;1300;1295;1294;1019;1019;1021;1011;
1401032;"Radzanów (2)";3908;3917;3901;3880;928;899;867;856;2312;2341;2359;2352;1530;1550;1571;1559;782;791;788;793;668;677;675;672;
1401042;"Stara Błotnica (2)";5194;5193;5177;5220;1255;1222;1181;1199;3203;3245;3263;3287;2147;2165;2175;2181;1056;1080;1088;1106;736;726;733;734;
1401052;"Stromiec (2)";5738;5713;5690;5668;1240;1207;1172;1150;3599;3611;3619;3610;2333;2339;2339;2320;1266;1272;1280;1290;899;895;899;908;
1401063;"Wyśmierzyce (3)";2846;2849;2848;2832;578;564;550;551;1779;1794;1806;1797;1094;1096;1106;1101;685;698;700;696;489;491;492;484;
1401064;"Wyśmierzyce - miasto (4)";908;906;921;924;176;168;168;176;614;620;632;625;378;373;386;378;236;247;246;247;118;118;121;123;
1401065;"Wyśmierzyce - obszar wiejski (5)";1938;1943;1927;1908;402;396;382;375;1165;1174;1174;1172;716;723;720;723;449;451;454;449;371;373;371;361;
1402011;"Ciechanów (1)";44974;44797;44585;44506;7739;7595;7490;7453;29858;29439;28903;28427;17385;17218;17035;16834;12473;12221;11868;11593;7377;7763;8192;8626;
1402022;"Ciechanów (2)";6799;6885;6941;6909;1433;1447;1436;1397;4351;4391;4431;4414;2768;2802;2835;2804;1583;1589;1596;1610;1015;1047;1074;1098;
1402033;"Glinojeck (3)";8152;8166;8108;8029;1723;1706;1670;1632;5098;5085;5028;4970;3193;3178;3135;3093;1905;1907;1893;1877;1331;1375;1410;1427;
1402034;"Glinojeck - miasto (4)";3142;3150;3113;3070;625;624;600;572;2127;2112;2070;2042;1280;1283;1257;1237;847;829;813;805;390;414;443;456;
1402035;"Glinojeck - obszar wiejski (5)";5010;5016;4995;4959;1098;1082;1070;1060;2971;2973;2958;2928;1913;1895;1878;1856;1058;1078;1080;1072;941;961;967;971;
1402042;"Gołymin-Ośrodek (2)";3966;3934;3957;3908;842;828;812;792;2499;2470;2480;2460;1582;1555;1572;1565;917;915;908;895;625;636;665;656;
1402052;"Grudusk (2)";3858;3823;3794;3748;781;767;738;719;2393;2370;2363;2310;1439;1424;1421;1396;954;946;942;914;684;686;693;719;
1402062;"Ojrzeń (2)";4409;4384;4373;4344;904;890;888;856;2796;2779;2773;2771;1756;1755;1749;1749;1040;1024;1024;1022;709;715;712;717;
1402072;"Opinogóra Górna (2)";5995;5982;5983;5980;1219;1178;1161;1156;3780;3807;3816;3795;2419;2438;2437;2430;1361;1369;1379;1365;996;997;1006;1029;
1402082;"Regimin (2)";5114;5069;5087;5049;1063;1016;1020;972;3220;3214;3214;3196;2001;1990;1970;1983;1219;1224;1244;1213;831;839;853;881;
1402092;"Sońsk (2)";7976;7938;7875;7854;1585;1598;1550;1516;4960;4899;4868;4830;3098;3028;3009;2994;1862;1871;1859;1836;1431;1441;1457;1508;
1403011;"Garwolin (1)";17147;17146;17174;17214;3680;3654;3700;3708;10758;10645;10511;10397;6993;6973;6894;6819;3765;3672;3617;3578;2709;2847;2963;3109;
1403021;"Łaskarzew (1)";4929;4914;4910;4915;980;945;933;923;3220;3217;3189;3164;2079;2083;2065;2053;1141;1134;1124;1111;729;752;788;828;
1403032;"Borowie (2)";5234;5217;5234;5215;1177;1138;1114;1081;3163;3177;3224;3228;2105;2111;2130;2127;1058;1066;1094;1101;894;902;896;906;
1403042;"Garwolin (2)";12744;12820;12912;13034;3075;3062;3065;3108;7857;7919;7970;7987;5294;5337;5377;5385;2563;2582;2593;2602;1812;1839;1877;1939;
1403052;"Górzno (2)";6326;6317;6346;6399;1411;1408;1410;1423;3937;3927;3923;3949;2649;2652;2660;2677;1288;1275;1263;1272;978;982;1013;1027;
1403062;"Łaskarzew (2)";5481;5467;5513;5513;1233;1199;1187;1168;3452;3460;3490;3491;2286;2309;2342;2332;1166;1151;1148;1159;796;808;836;854;
1403072;"Maciejowice (2)";7233;7188;7148;7090;1486;1400;1358;1314;4413;4471;4455;4431;2782;2836;2827;2807;1631;1635;1628;1624;1334;1317;1335;1345;
1403082;"Miastków Kościelny (2)";4974;4977;4935;4914;1039;1036;1016;1030;3025;3046;3019;2990;1998;2010;1988;1967;1027;1036;1031;1023;910;895;900;894;
1403092;"Parysów (2)";4061;4055;4102;4106;957;940;944;944;2445;2449;2473;2483;1621;1639;1664;1648;824;810;809;835;659;666;685;679;
1403103;"Pilawa (3)";10764;10850;10884;10920;2334;2349;2375;2380;6877;6901;6875;6852;4480;4505;4463;4432;2397;2396;2412;2420;1553;1600;1634;1688;
1403104;"Pilawa - miasto (4)";4374;4438;4484;4510;989;1002;1018;1029;2861;2883;2892;2878;1869;1886;1863;1847;992;997;1029;1031;524;553;574;603;
1403105;"Pilawa - obszar wiejski (5)";6390;6412;6400;6410;1345;1347;1357;1351;4016;4018;3983;3974;2611;2619;2600;2585;1405;1399;1383;1389;1029;1047;1060;1085;
1403112;"Sobolew (2)";8300;8298;8258;8237;1849;1820;1779;1770;5127;5122;5101;5065;3294;3290;3281;3260;1833;1832;1820;1805;1324;1356;1378;1402;
1403122;"Trojanów (2)";7558;7509;7492;7444;1555;1528;1531;1510;4551;4539;4518;4481;2881;2870;2858;2855;1670;1669;1660;1626;1452;1442;1443;1453;
1403132;"Wilga (2)";5370;5396;5360;5352;1065;1065;1051;1024;3301;3315;3294;3300;2101;2113;2079;2088;1200;1202;1215;1212;1004;1016;1015;1028;
1403143;"Żelechów (3)";8471;8408;8386;8387;1850;1838;1801;1794;5355;5287;5248;5229;3422;3359;3344;3328;1933;1928;1904;1901;1266;1283;1337;1364;
1403144;"Żelechów - miasto (4)";4152;4081;4061;4067;885;879;859;869;2717;2640;2610;2571;1653;1587;1582;1568;1064;1053;1028;1003;550;562;592;627;
1403145;"Żelechów - obszar wiejski (5)";4319;4327;4325;4320;965;959;942;925;2638;2647;2638;2658;1769;1772;1762;1760;869;875;876;898;716;721;745;737;
1404011;"Gostynin (1)";19205;19092;18947;18895;3314;3226;3160;3072;12283;12063;11853;11742;7346;7243;7145;7134;4937;4820;4708;4608;3608;3803;3934;4081;
1404022;"Gostynin (2)";12185;12232;12217;12210;2472;2424;2358;2296;7692;7713;7720;7716;4846;4866;4871;4869;2846;2847;2849;2847;2021;2095;2139;2198;
1404032;"Pacyna (2)";3795;3767;3730;3690;590;605;593;585;2360;2320;2286;2248;1409;1369;1342;1318;951;951;944;930;845;842;851;857;
1404042;"Sanniki (2)";6350;6332;6278;6217;1170;1150;1126;1097;3994;3981;3924;3876;2457;2452;2433;2412;1537;1529;1491;1464;1186;1201;1228;1244;
1404052;"Szczawin Kościelny (2)";5092;5094;5049;4980;925;919;894;857;3215;3191;3185;3150;2034;2017;2006;1982;1181;1174;1179;1168;952;984;970;973;
1405011;"Milanówek (1)";16387;16410;16353;16371;2891;2909;2906;2952;10235;10095;9971;9795;6136;6092;6051;5977;4099;4003;3920;3818;3261;3406;3476;3624;
1405021;"Podkowa Leśna (1)";3923;3869;3845;3863;716;695;690;699;2288;2225;2173;2148;1275;1247;1232;1225;1013;978;941;923;919;949;982;1016;
1405032;"Baranów (2)";5045;5068;5101;5194;1036;1045;1053;1096;3170;3163;3177;3196;2030;2030;2037;2057;1140;1133;1140;1139;839;860;871;902;
1405043;"Grodzisk Mazowiecki (3)";43353;44029;44718;45259;8860;9073;9369;9507;27288;27430;27562;27650;17411;17557;17729;17788;9877;9873;9833;9862;7205;7526;7787;8102;
1405044;"Grodzisk Mazowiecki - miasto (4)";29763;29907;30180;30356;5760;5799;5979;6041;18547;18434;18352;18281;11802;11781;11792;11742;6745;6653;6560;6539;5456;5674;5849;6034;
1405045;"Grodzisk Mazowiecki - obszar wiejski (5)";13590;14122;14538;14903;3100;3274;3390;3466;8741;8996;9210;9369;5609;5776;5937;6046;3132;3220;3273;3323;1749;1852;1938;2068;
1405052;"Jaktorów (2)";11131;11350;11555;11722;2298;2350;2421;2475;7118;7200;7234;7277;4476;4579;4599;4617;2642;2621;2635;2660;1715;1800;1900;1970;
1405062;"Żabia Wola (2)";7680;7908;8091;8247;1719;1772;1796;1839;4871;4991;5080;5133;3135;3232;3256;3295;1736;1759;1824;1838;1090;1145;1215;1275;
1406012;"Belsk Duży (2)";6641;6620;6600;6596;1263;1220;1210;1187;4131;4117;4077;4044;2526;2527;2486;2479;1605;1590;1591;1565;1247;1283;1313;1365;
1406022;"Błędów (2)";7722;7687;7672;7620;1484;1453;1429;1419;4715;4673;4665;4611;2871;2873;2843;2798;1844;1800;1822;1813;1523;1561;1578;1590;
1406032;"Chynów (2)";9710;9752;9789;9804;1922;1919;1929;1925;6257;6250;6223;6191;3971;3983;3960;3946;2286;2267;2263;2245;1531;1583;1637;1688;
1406042;"Goszczyn (2)";3000;2988;2971;2983;696;676;651;645;1826;1828;1835;1840;1176;1183;1184;1184;650;645;651;656;478;484;485;498;
1406053;"Grójec (3)";25125;25286;25403;25463;4920;4988;5014;5014;15998;15904;15762;15642;10103;10110;10104;10078;5895;5794;5658;5564;4207;4394;4627;4807;
1406054;"Grójec - miasto (4)";16333;16453;16534;16579;3167;3220;3261;3279;10410;10328;10204;10102;6652;6663;6629;6591;3758;3665;3575;3511;2756;2905;3069;3198;
1406055;"Grójec - obszar wiejski (5)";8792;8833;8869;8884;1753;1768;1753;1735;5588;5576;5558;5540;3451;3447;3475;3487;2137;2129;2083;2053;1451;1489;1558;1609;
1406062;"Jasieniec (2)";5415;5402;5402;5395;1121;1101;1086;1085;3353;3344;3333;3314;2105;2111;2111;2096;1248;1233;1222;1218;941;957;983;996;
1406073;"Mogielnica (3)";9008;8954;8852;8861;1584;1555;1510;1511;5598;5552;5492;5468;3374;3354;3314;3303;2224;2198;2178;2165;1826;1847;1850;1882;
1406074;"Mogielnica - miasto (4)";2417;2386;2352;2337;412;408;396;394;1525;1478;1441;1424;894;865;855;842;631;613;586;582;480;500;515;519;
1406075;"Mogielnica - obszar wiejski (5)";6591;6568;6500;6524;1172;1147;1114;1117;4073;4074;4051;4044;2480;2489;2459;2461;1593;1585;1592;1583;1346;1347;1335;1363;
1406083;"Nowe Miasto nad Pilicą (3)";8188;8106;8039;7942;1253;1208;1202;1194;5153;5082;5000;4885;2969;2943;2910;2854;2184;2139;2090;2031;1782;1816;1837;1863;
1406084;"Nowe Miasto nad Pilicą - miasto (4)";3980;3920;3890;3862;608;574;558;563;2546;2490;2468;2405;1459;1433;1420;1394;1087;1057;1048;1011;826;856;864;894;
1406085;"Nowe Miasto nad Pilicą - obszar wiejski (5)";4208;4186;4149;4080;645;634;644;631;2607;2592;2532;2480;1510;1510;1490;1460;1097;1082;1042;1020;956;960;973;969;
1406092;"Pniewy (2)";4701;4726;4743;4748;965;970;972;968;2962;2958;2943;2934;1854;1867;1869;1865;1108;1091;1074;1069;774;798;828;846;
1406113;"Warka (3)";19133;19188;19199;19207;3724;3692;3642;3658;12259;12219;12181;12058;7581;7585;7613;7609;4678;4634;4568;4449;3150;3277;3376;3491;
1406114;"Warka - miasto (4)";11666;11727;11777;11835;2239;2228;2210;2229;7652;7630;7617;7566;4762;4773;4799;4825;2890;2857;2818;2741;1775;1869;1950;2040;
1406115;"Warka - obszar wiejski (5)";7467;7461;7422;7372;1485;1464;1432;1429;4607;4589;4564;4492;2819;2812;2814;2784;1788;1777;1750;1708;1375;1408;1426;1451;
1407012;"Garbatka-Letnisko (2)";5245;5239;5188;5129;899;887;848;805;3299;3290;3242;3214;1946;1939;1928;1904;1353;1351;1314;1310;1047;1062;1098;1110;
1407022;"Głowaczów (2)";7460;7409;7365;7301;1467;1419;1392;1335;4666;4678;4677;4643;2923;2937;2944;2944;1743;1741;1733;1699;1327;1312;1296;1323;
1407032;"Gniewoszów (2)";4067;4031;4019;3985;709;696;705;691;2536;2512;2490;2474;1521;1514;1516;1514;1015;998;974;960;822;823;824;820;
1407042;"Grabów nad Pilicą (2)";3952;3950;3945;3915;872;851;832;791;2409;2417;2438;2426;1539;1539;1569;1559;870;878;869;867;671;682;675;698;
1407053;"Kozienice (3)";30636;30561;30353;30164;5399;5348;5255;5138;20053;19656;19269;18866;12121;12048;11896;11683;7932;7608;7373;7183;5184;5557;5829;6160;
1407054;"Kozienice - miasto (4)";18422;18277;18064;17869;3023;2987;2938;2876;12001;11602;11218;10849;7090;6992;6843;6650;4911;4610;4375;4199;3398;3688;3908;4144;
1407055;"Kozienice - obszar wiejski (5)";12214;12284;12289;12295;2376;2361;2317;2262;8052;8054;8051;8017;5031;5056;5053;5033;3021;2998;2998;2984;1786;1869;1921;2016;
1407062;"Magnuszew (2)";6805;6831;6796;6796;1383;1371;1331;1323;4314;4311;4297;4274;2718;2718;2717;2700;1596;1593;1580;1574;1108;1149;1168;1199;
1407072;"Sieciechów (2)";4110;4079;4056;4029;794;767;761;749;2528;2520;2508;2501;1574;1576;1545;1540;954;944;963;961;788;792;787;779;
1408011;"Legionowo (1)";54109;54231;54272;54172;10406;10557;10543;10563;33902;33349;32836;32273;21927;21827;21700;21445;11975;11522;11136;10828;9801;10325;10893;11336;
1408022;"Jabłonna (2)";17202;17531;17951;18364;4173;4238;4383;4508;11131;11280;11428;11555;7628;7665;7750;7796;3503;3615;3678;3759;1898;2013;2140;2301;
1408032;"Nieporęt (2)";13292;13466;13707;13917;3002;3047;3043;3063;8425;8424;8550;8621;5249;5282;5353;5429;3176;3142;3197;3192;1865;1995;2114;2233;
1408043;"Serock (3)";13394;13676;13896;14073;2789;2865;2861;2914;8737;8827;8904;8931;5447;5509;5608;5597;3290;3318;3296;3334;1868;1984;2131;2228;
1408044;"Serock - miasto (4)";4089;4130;4175;4220;838;844;839;856;2666;2682;2691;2689;1638;1619;1641;1631;1028;1063;1050;1058;585;604;645;675;
1408045;"Serock - obszar wiejski (5)";9305;9546;9721;9853;1951;2021;2022;2058;6071;6145;6213;6242;3809;3890;3967;3966;2262;2255;2246;2276;1283;1380;1486;1553;
1408052;"Wieliszew (2)";11892;12145;12400;12716;2528;2583;2609;2711;7793;7891;8034;8141;4951;5039;5152;5203;2842;2852;2882;2938;1571;1671;1757;1864;
1409012;"Chotcza (2)";2499;2448;2409;2385;431;407;404;395;1485;1475;1448;1433;891;895;877;865;594;580;571;568;583;566;557;557;
1409022;"Ciepielów (2)";5747;5723;5724;5674;1125;1080;1065;1048;3513;3511;3537;3494;2214;2225;2223;2202;1299;1286;1314;1292;1109;1132;1122;1132;
1409033;"Lipsko (3)";11607;11505;11397;11348;1904;1827;1770;1745;7497;7429;7288;7192;4422;4384;4318;4279;3075;3045;2970;2913;2206;2249;2339;2411;
1409034;"Lipsko - miasto (4)";5895;5816;5732;5718;881;824;785;789;3922;3856;3758;3683;2205;2173;2120;2082;1717;1683;1638;1601;1092;1136;1189;1246;
1409035;"Lipsko - obszar wiejski (5)";5712;5689;5665;5630;1023;1003;985;956;3575;3573;3530;3509;2217;2211;2198;2197;1358;1362;1332;1312;1114;1113;1150;1165;
1409042;"Rzeczniów (2)";4637;4589;4570;4534;805;780;770;765;2877;2850;2854;2817;1798;1781;1772;1756;1079;1069;1082;1061;955;959;946;952;
1409052;"Sienno (2)";6098;6079;6049;6011;1072;1077;1071;1052;3764;3726;3709;3671;2254;2242;2233;2208;1510;1484;1476;1463;1262;1276;1269;1288;
1409062;"Solec nad Wisłą (2)";5304;5220;5160;5111;879;838;832;846;3208;3140;3081;3018;1900;1846;1805;1771;1308;1294;1276;1247;1217;1242;1247;1247;
1410012;"Huszlew (2)";2979;2939;2932;2896;597;567;572;571;1717;1702;1694;1653;1059;1046;1032;1000;658;656;662;653;665;670;666;672;
1410023;"Łosice (3)";11033;10954;10961;10929;2069;2039;2020;2009;7021;6927;6898;6780;4303;4264;4272;4209;2718;2663;2626;2571;1943;1988;2043;2140;
1410024;"Łosice - miasto (4)";7120;7099;7102;7085;1335;1318;1318;1305;4576;4511;4457;4378;2776;2763;2752;2715;1800;1748;1705;1663;1209;1270;1327;1402;
1410025;"Łosice - obszar wiejski (5)";3913;3855;3859;3844;734;721;702;704;2445;2416;2441;2402;1527;1501;1520;1494;918;915;921;908;734;718;716;738;
1410032;"Olszanka (2)";3117;3092;3051;3043;624;611;587;593;1916;1898;1872;1856;1173;1167;1162;1151;743;731;710;705;577;583;592;594;
1410042;"Platerów (2)";5098;5056;5035;5020;971;948;934;942;3096;3084;3077;3052;1916;1908;1928;1914;1180;1176;1149;1138;1031;1024;1024;1026;
1410052;"Sarnaki (2)";5022;5035;4996;4922;868;830;811;784;3060;3109;3071;3014;1849;1899;1872;1843;1211;1210;1199;1171;1094;1096;1114;1124;
1410062;"Stara Kornica (2)";5059;5025;4998;4965;1025;989;944;932;3034;3035;3036;3023;1982;1985;2000;1995;1052;1050;1036;1028;1000;1001;1018;1010;
1411011;"Maków Mazowiecki (1)";10211;10118;10077;10006;1976;1915;1889;1855;6488;6353;6256;6086;3962;3917;3894;3824;2526;2436;2362;2262;1747;1850;1932;2065;
1411022;"Czerwonka (2)";2698;2703;2715;2698;574;549;561;540;1644;1675;1675;1669;1000;1018;1027;1019;644;657;648;650;480;479;479;489;
1411032;"Karniewo (2)";5363;5314;5299;5264;1184;1125;1122;1085;3303;3315;3291;3266;2039;2042;2042;2013;1264;1273;1249;1253;876;874;886;913;
1411042;"Krasnosielc (2)";6610;6594;6531;6484;1453;1425;1381;1338;4011;4005;3969;3956;2548;2545;2517;2527;1463;1460;1452;1429;1146;1164;1181;1190;
1411052;"Młynarze (2)";1759;1765;1788;1767;367;365;372;355;1084;1096;1105;1104;705;713;711;708;379;383;394;396;308;304;311;308;
1411062;"Płoniawy-Bramura (2)";5744;5679;5659;5583;1119;1086;1044;997;3620;3574;3573;3517;2170;2126;2140;2092;1450;1448;1433;1425;1005;1019;1042;1069;
1411073;"Różan (3)";4527;4506;4490;4462;856;844;844;834;2889;2843;2792;2753;1781;1765;1739;1715;1108;1078;1053;1038;782;819;854;875;
1411074;"Różan - miasto (4)";2740;2730;2729;2724;477;474;476;485;1824;1784;1750;1721;1128;1118;1105;1091;696;666;645;630;439;472;503;518;
1411075;"Różan - obszar wiejski (5)";1787;1776;1761;1738;379;370;368;349;1065;1059;1042;1032;653;647;634;624;412;412;408;408;343;347;351;357;
1411082;"Rzewnie (2)";2710;2707;2686;2655;556;543;514;506;1628;1628;1630;1595;1025;1021;1026;1001;603;607;604;594;526;536;542;554;
1411092;"Sypniewo (2)";3456;3461;3427;3384;684;681;659;646;2167;2159;2132;2111;1274;1280;1284;1279;893;879;848;832;605;621;636;627;
1411102;"Szelków (2)";3758;3730;3693;3711;781;770;744;743;2287;2258;2243;2242;1439;1403;1380;1383;848;855;863;859;690;702;706;726;
1412011;"Mińsk Mazowiecki (1)";39668;39880;40211;40334;8136;8203;8322;8358;24963;24897;24790;24570;16208;16244;16252;16129;8755;8653;8538;8441;6569;6780;7099;7406;
1412042;"Cegłów (2)";6184;6180;6217;6194;1080;1063;1080;1075;3803;3801;3779;3768;2262;2241;2249;2268;1541;1560;1530;1500;1301;1316;1358;1351;
1412052;"Dębe Wielkie (2)";9390;9565;9701;9823;2080;2136;2162;2184;5966;6033;6073;6138;3912;3970;4017;4064;2054;2063;2056;2074;1344;1396;1466;1501;
1412062;"Dobre (2)";6022;6012;6000;6016;1240;1202;1195;1218;3724;3730;3702;3675;2306;2330;2324;2306;1418;1400;1378;1369;1058;1080;1103;1123;
1412073;"Halinów (3)";14769;15070;15341;15527;3486;3583;3612;3619;9348;9448;9594;9695;6161;6249;6352;6380;3187;3199;3242;3315;1935;2039;2135;2213;
1412074;"Halinów - miasto (4)";3612;3654;3675;3688;774;783;768;760;2294;2305;2310;2318;1485;1491;1484;1481;809;814;826;837;544;566;597;610;
1412075;"Halinów - obszar wiejski (5)";11157;11416;11666;11839;2712;2800;2844;2859;7054;7143;7284;7377;4676;4758;4868;4899;2378;2385;2416;2478;1391;1473;1538;1603;
1412082;"Jakubów (2)";5077;5078;5076;5067;1096;1077;1095;1082;3107;3128;3107;3089;2033;2040;2015;1989;1074;1088;1092;1100;874;873;874;896;
1412093;"Kałuszyn (3)";5993;5938;5958;5933;1185;1161;1157;1137;3731;3681;3663;3646;2317;2302;2290;2259;1414;1379;1373;1387;1077;1096;1138;1150;
1412094;"Kałuszyn - miasto (4)";2945;2934;2938;2924;614;610;602;582;1879;1855;1844;1842;1167;1159;1162;1146;712;696;682;696;452;469;492;500;
1412095;"Kałuszyn - obszar wiejski (5)";3048;3004;3020;3009;571;551;555;555;1852;1826;1819;1804;1150;1143;1128;1113;702;683;691;691;625;627;646;650;
1412102;"Latowicz (2)";5488;5478;5460;5460;1204;1174;1180;1182;3337;3351;3316;3325;2104;2109;2091;2095;1233;1242;1225;1230;947;953;964;953;
1412112;"Mińsk Mazowiecki (2)";14323;14628;14722;14856;3108;3168;3148;3124;9218;9393;9434;9520;5917;6094;6110;6150;3301;3299;3324;3370;1997;2067;2140;2212;
1412122;"Mrozy (2)";8738;8785;;;1692;1723;;;5435;5422;;;3404;3411;;;2031;2011;;;1611;1640;;;
1412123;"Mrozy (3)";;;8737;8743;;;1713;1702;;;5362;5341;;;3380;3403;;;1982;1938;;;1662;1700;
1412124;"Mrozy - miasto (4)";;;3528;3546;;;699;693;;;2138;2139;;;1355;1365;;;783;774;;;691;714;
1412125;"Mrozy - obszar wiejski (5)";;;5209;5197;;;1014;1009;;;3224;3202;;;2025;2038;;;1199;1164;;;971;986;
1412132;"Siennica (2)";7344;7332;7371;7409;1459;1457;1460;1467;4619;4598;4576;4554;2885;2882;2908;2907;1734;1716;1668;1647;1266;1277;1335;1388;
1412142;"Stanisławów (2)";6605;6640;6684;6677;1413;1410;1394;1381;4191;4202;4226;4217;2698;2703;2730;2736;1493;1499;1496;1481;1001;1028;1064;1079;
1412151;"Sulejówek (1)";19328;19311;19411;19481;3581;3540;3578;3609;12112;12043;12008;11899;7434;7424;7366;7302;4678;4619;4642;4597;3635;3728;3825;3973;
1413011;"Mława (1)";30969;30880;30968;31030;5772;5693;5631;5642;20068;19882;19819;19622;12382;12291;12339;12259;7686;7591;7480;7363;5129;5305;5518;5766;
1413022;"Dzierzgowo (2)";3323;3301;3262;3221;686;659;634;615;1979;1973;1960;1945;1199;1205;1223;1198;780;768;737;747;658;669;668;661;
1413032;"Lipowiec Kościelny (2)";4953;4928;4917;4913;1081;1049;1010;984;2997;3004;3019;3043;1869;1872;1882;1893;1128;1132;1137;1150;875;875;888;886;
1413042;"Radzanów (2)";3537;3503;3474;3412;782;750;714;677;2095;2098;2110;2105;1344;1340;1338;1325;751;758;772;780;660;655;650;630;
1413052;"Strzegowo (2)";7844;7802;7736;7713;1511;1484;1427;1397;4872;4852;4839;4811;3024;2985;3001;2991;1848;1867;1838;1820;1461;1466;1470;1505;
1413062;"Stupsk (2)";5046;4996;4972;4969;1027;1001;972;957;3149;3126;3140;3133;2010;1980;1973;1952;1139;1146;1167;1181;870;869;860;879;
1413072;"Szreńsk (2)";4421;4366;4346;4293;927;889;876;835;2741;2740;2725;2712;1709;1727;1701;1720;1032;1013;1024;992;753;737;745;746;
1413082;"Szydłowo (2)";4704;4653;4664;4672;986;943;939;925;2927;2923;2926;2926;1867;1869;1870;1874;1060;1054;1056;1052;791;787;799;821;
1413092;"Wieczfnia Kościelna (2)";4222;4222;4182;4169;926;916;879;871;2635;2625;2602;2594;1698;1708;1700;1686;937;917;902;908;661;681;701;704;
1413102;"Wiśniewo (2)";5401;5391;5366;5366;1149;1120;1109;1101;3363;3372;3366;3379;2183;2198;2167;2155;1180;1174;1199;1224;889;899;891;886;
1414011;"Nowy Dwór Mazowiecki (1)";28261;28287;28364;28362;5323;5267;5329;5352;18228;18083;17851;17606;11388;11430;11376;11270;6840;6653;6475;6336;4710;4937;5184;5404;
1414022;"Czosnów (2)";9619;9690;9806;9852;1902;1911;1940;1921;6238;6264;6294;6256;3812;3831;3857;3817;2426;2433;2437;2439;1479;1515;1572;1675;
1414032;"Leoncin (2)";5473;5512;5532;5556;1057;1056;1049;1061;3509;3503;3489;3489;2176;2180;2179;2180;1333;1323;1310;1309;907;953;994;1006;
1414043;"Nasielsk (3)";19780;19782;19821;19868;3934;3881;3837;3806;12807;12788;12778;12756;8085;8087;8080;8105;4722;4701;4698;4651;3039;3113;3206;3306;
1414044;"Nasielsk - miasto (4)";7665;7650;7629;7658;1413;1394;1383;1388;5086;5047;4983;4940;3105;3097;3042;3038;1981;1950;1941;1902;1166;1209;1263;1330;
1414045;"Nasielsk - obszar wiejski (5)";12115;12132;12192;12210;2521;2487;2454;2418;7721;7741;7795;7816;4980;4990;5038;5067;2741;2751;2757;2749;1873;1904;1943;1976;
1414052;"Pomiechówek (2)";8992;9026;8988;9008;1705;1700;1645;1639;5718;5708;5673;5651;3444;3489;3474;3485;2274;2219;2199;2166;1569;1618;1670;1718;
1414063;"Zakroczym (3)";6196;6203;6182;6164;1184;1150;1131;1119;4065;4064;4037;3989;2457;2460;2449;2441;1608;1604;1588;1548;947;989;1014;1056;
1414064;"Zakroczym - miasto (4)";3249;3241;3231;3244;590;587;589;592;2157;2124;2097;2071;1261;1241;1228;1229;896;883;869;842;502;530;545;581;
1414065;"Zakroczym - obszar wiejski (5)";2947;2962;2951;2920;594;563;542;527;1908;1940;1940;1918;1196;1219;1221;1212;712;721;719;706;445;459;469;475;
1415012;"Baranowo (2)";6805;6764;6727;6667;1395;1342;1297;1269;4131;4165;4159;4133;2653;2650;2610;2578;1478;1515;1549;1555;1279;1257;1271;1265;
1415022;"Czarnia (2)";2717;2679;2648;2642;667;612;598;594;1635;1664;1651;1660;1111;1134;1118;1118;524;530;533;542;415;403;399;388;
1415032;"Czerwin (2)";5161;5167;5176;5157;1012;990;995;974;3176;3194;3187;3134;1948;1972;1963;1971;1228;1222;1224;1163;973;983;994;1049;
1415042;"Goworowo (2)";8672;8640;8585;8474;1752;1733;1687;1599;5358;5316;5272;5241;3357;3320;3285;3276;2001;1996;1987;1965;1562;1591;1626;1634;
1415052;"Kadzidło (2)";11452;11465;11460;11435;2684;2605;2538;2460;7235;7313;7343;7385;4763;4804;4802;4822;2472;2509;2541;2563;1533;1547;1579;1590;
1415062;"Lelis (2)";9024;9164;9311;9387;2153;2146;2159;2145;5804;5907;6024;6062;3882;3919;3964;3991;1922;1988;2060;2071;1067;1111;1128;1180;
1415072;"Łyse (2)";8397;8410;8434;8438;1956;1894;1897;1895;5223;5296;5315;5320;3542;3566;3534;3492;1681;1730;1781;1828;1218;1220;1222;1223;
1415083;"Myszyniec (3)";10591;10575;10600;10511;2405;2308;2255;2163;6645;6710;6765;6757;4399;4426;4405;4369;2246;2284;2360;2388;1541;1557;1580;1591;
1415084;"Myszyniec - miasto (4)";3139;3170;3294;3368;634;624;628;619;2125;2153;2205;2258;1348;1369;1391;1424;777;784;814;834;380;393;461;491;
1415085;"Myszyniec - obszar wiejski (5)";7452;7405;7306;7143;1771;1684;1627;1544;4520;4557;4560;4499;3051;3057;3014;2945;1469;1500;1546;1554;1161;1164;1119;1100;
1415092;"Olszewo-Borki (2)";10114;10239;10274;10356;2326;2293;2254;2236;6538;6645;6671;6734;4220;4260;4263;4293;2318;2385;2408;2441;1250;1301;1349;1386;
1415102;"Rzekuń (2)";9959;10094;10287;10422;2168;2154;2165;2187;6504;6602;6728;6785;4158;4196;4276;4320;2346;2406;2452;2465;1287;1338;1394;1450;
1415112;"Troszyn (2)";4938;4919;4911;4889;1001;1008;986;971;3059;3043;3022;3008;1917;1904;1908;1904;1142;1139;1114;1104;878;868;903;910;
1416011;"Ostrów Mazowiecka (1)";22837;22796;22792;22772;4530;4433;4341;4206;14603;14500;14428;14366;9027;8986;8953;8944;5576;5514;5475;5422;3704;3863;4023;4200;
1416022;"Andrzejewo (2)";4369;4318;4309;4237;826;791;773;737;2641;2625;2624;2586;1667;1670;1673;1645;974;955;951;941;902;902;912;914;
1416032;"Boguty-Pianki (2)";2799;2761;2727;2678;539;513;487;466;1700;1671;1663;1643;1048;1034;1033;1034;652;637;630;609;560;577;577;569;
1416043;"Brok (3)";2934;2921;2924;2895;552;538;534;531;1832;1815;1825;1793;1147;1129;1127;1094;685;686;698;699;550;568;565;571;
1416044;"Brok - miasto (4)";1983;1977;1984;1959;366;353;353;350;1268;1263;1276;1246;774;765;768;737;494;498;508;509;349;361;355;363;
1416045;"Brok - obszar wiejski (5)";951;944;940;936;186;185;181;181;564;552;549;547;373;364;359;357;191;188;190;190;201;207;210;208;
1416052;"Małkinia Górna (2)";12129;12048;11982;11852;2321;2274;2233;2188;7775;7689;7609;7465;4746;4672;4625;4557;3029;3017;2984;2908;2033;2085;2140;2199;
1416062;"Nur (2)";2974;2934;2879;2826;477;449;424;406;1712;1715;1690;1678;1014;1015;1000;992;698;700;690;686;785;770;765;742;
1416072;"Ostrów Mazowiecka (2)";12972;12978;12917;12889;2752;2706;2635;2567;7953;7994;7999;8000;5144;5167;5136;5130;2809;2827;2863;2870;2267;2278;2283;2322;
1416082;"Stary Lubotyń (2)";3878;3857;3807;3806;832;805;768;764;2321;2332;2329;2326;1442;1449;1461;1470;879;883;868;856;725;720;710;716;
1416092;"Szulborze Wielkie (2)";1804;1798;1774;1747;341;319;304;295;1104;1113;1107;1087;699;707;690;682;405;406;417;405;359;366;363;365;
1416102;"Wąsewo (2)";4500;4476;4459;4430;870;855;831;832;2755;2746;2738;2692;1738;1746;1738;1723;1017;1000;1000;969;875;875;890;906;
1416112;"Zaręby Kościelne (2)";3802;3796;3778;3779;779;760;738;740;2246;2249;2245;2252;1427;1413;1397;1392;819;836;848;860;777;787;795;787;
1417011;"Józefów (1)";19947;19914;20137;20229;4301;4297;4314;4343;12154;12034;12076;11996;7573;7473;7492;7423;4581;4561;4584;4573;3492;3583;3747;3890;
1417021;"Otwock (1)";44944;45044;45025;45021;8171;8163;8200;8226;27544;27401;27197;27009;17293;17195;17085;16906;10251;10206;10112;10103;9229;9480;9628;9786;
1417032;"Celestynów (2)";11547;11576;11607;11623;2321;2327;2326;2306;7422;7367;7337;7276;4732;4691;4664;4623;2690;2676;2673;2653;1804;1882;1944;2041;
1417043;"Karczew (3)";16041;16018;15943;15905;2820;2793;2734;2751;10383;10294;10156;9976;6363;6323;6285;6183;4020;3971;3871;3793;2838;2931;3053;3178;
1417044;"Karczew - miasto (4)";10177;10160;10082;10009;1662;1648;1628;1622;6621;6535;6393;6245;4019;3976;3932;3837;2602;2559;2461;2408;1894;1977;2061;2142;
1417045;"Karczew - obszar wiejski (5)";5864;5858;5861;5896;1158;1145;1106;1129;3762;3759;3763;3731;2344;2347;2353;2346;1418;1412;1410;1385;944;954;992;1036;
1417052;"Kołbiel (2)";8111;8151;8173;8156;1601;1618;1647;1617;5119;5128;5107;5085;3235;3246;3235;3230;1884;1882;1872;1855;1391;1405;1419;1454;
1417062;"Osieck (2)";3534;3525;3539;3568;705;708;698;714;2181;2167;2180;2179;1420;1424;1423;1428;761;743;757;751;648;650;661;675;
1417072;"Sobienie-Jeziory (2)";6332;6358;6395;6375;1122;1126;1156;1162;3965;3977;3972;3967;2470;2463;2455;2431;1495;1514;1517;1536;1245;1255;1267;1246;
1417082;"Wiązowna (2)";11521;11756;12035;12243;2591;2639;2722;2774;7339;7472;7545;7609;4705;4790;4851;4863;2634;2682;2694;2746;1591;1645;1768;1860;
1418013;"Góra Kalwaria (3)";25701;25828;25950;26244;5059;5006;5045;5104;16355;16347;16274;16255;10466;10499;10414;10411;5889;5848;5860;5844;4287;4475;4631;4885;
1418014;"Góra Kalwaria - miasto (4)";11651;11685;11658;11815;2242;2206;2218;2273;7209;7168;7067;7043;4611;4614;4529;4520;2598;2554;2538;2523;2200;2311;2373;2499;
1418015;"Góra Kalwaria - obszar wiejski (5)";14050;14143;14292;14429;2817;2800;2827;2831;9146;9179;9207;9212;5855;5885;5885;5891;3291;3294;3322;3321;2087;2164;2258;2386;
1418023;"Konstancin-Jeziorna (3)";24895;24805;24788;24763;4472;4394;4331;4312;15460;15244;15142;14998;9249;9099;9061;8924;6211;6145;6081;6074;4963;5167;5315;5453;
1418024;"Konstancin-Jeziorna - miasto (4)";17473;17391;17311;17249;3017;2970;2927;2880;10746;10571;10437;10329;6429;6312;6254;6151;4317;4259;4183;4178;3710;3850;3947;4040;
1418025;"Konstancin-Jeziorna - obszar wiejski (5)";7422;7414;7477;7514;1455;1424;1404;1432;4714;4673;4705;4669;2820;2787;2807;2773;1894;1886;1898;1896;1253;1317;1368;1413;
1418032;"Lesznowola (2)";22185;22904;23581;24486;5678;5895;6160;6467;14047;14368;14626;15026;9501;9741;9861;10108;4546;4627;4765;4918;2460;2641;2795;2993;
1418043;"Piaseczno (3)";75008;76693;78180;79741;16836;17311;17668;18156;47391;48031;48525;49009;32390;32859;33140;33242;15001;15172;15385;15767;10781;11351;11987;12576;
1418044;"Piaseczno - miasto (4)";44017;44869;45567;46316;9329;9590;9771;10034;28089;28359;28563;28795;19739;19960;20020;20131;8350;8399;8543;8664;6599;6920;7233;7487;
1418045;"Piaseczno - obszar wiejski (5)";30991;31824;32613;33425;7507;7721;7897;8122;19302;19672;19962;20214;12651;12899;13120;13111;6651;6773;6842;7103;4182;4431;4754;5089;
1418052;"Prażmów (2)";9941;10096;10308;10470;2235;2250;2296;2320;6327;6393;6505;6571;4047;4099;4125;4140;2280;2294;2380;2431;1379;1453;1507;1579;
1418063;"Tarczyn (3)";11205;11263;11278;11303;2258;2250;2219;2242;7032;7021;7009;6968;4495;4486;4472;4447;2537;2535;2537;2521;1915;1992;2050;2093;
1418064;"Tarczyn - miasto (4)";4121;4127;4089;4057;796;800;786;782;2578;2549;2500;2468;1671;1645;1609;1564;907;904;891;904;747;778;803;807;
1418065;"Tarczyn - obszar wiejski (5)";7084;7136;7189;7246;1462;1450;1433;1460;4454;4472;4509;4500;2824;2841;2863;2883;1630;1631;1646;1617;1168;1214;1247;1286;
1419012;"Bielsk (2)";9133;9121;9143;9113;1912;1862;1819;1772;5832;5835;5858;5852;3775;3786;3819;3792;2057;2049;2039;2060;1389;1424;1466;1489;
1419022;"Bodzanów (2)";8423;8416;8361;8319;1596;1541;1492;1452;5278;5289;5262;5221;3311;3320;3326;3290;1967;1969;1936;1931;1549;1586;1607;1646;
1419032;"Brudzeń Duży (2)";8189;8209;8237;8216;1765;1729;1680;1644;5170;5187;5227;5221;3363;3377;3412;3377;1807;1810;1815;1844;1254;1293;1330;1351;
1419042;"Bulkowo (2)";5838;5837;5779;5756;1225;1217;1164;1143;3595;3599;3589;3562;2310;2336;2340;2315;1285;1263;1249;1247;1018;1021;1026;1051;
1419053;"Drobin (3)";8316;8279;8219;8157;1796;1751;1708;1671;5158;5147;5110;5078;3284;3264;3226;3192;1874;1883;1884;1886;1362;1381;1401;1408;
1419054;"Drobin - miasto (4)";2999;2992;2963;2945;628;623;620;602;1934;1924;1892;1868;1200;1200;1176;1174;734;724;716;694;437;445;451;475;
1419055;"Drobin - obszar wiejski (5)";5317;5287;5256;5212;1168;1128;1088;1069;3224;3223;3218;3210;2084;2064;2050;2018;1140;1159;1168;1192;925;936;950;933;
1419063;"Gąbin (3)";11101;11070;11141;11096;2014;1986;1975;1925;6952;6913;6953;6931;4423;4366;4396;4359;2529;2547;2557;2572;2135;2171;2213;2240;
1419064;"Gąbin - miasto (4)";4174;4142;4183;4146;731;716;722;704;2654;2615;2627;2597;1626;1596;1606;1571;1028;1019;1021;1026;789;811;834;845;
1419065;"Gąbin - obszar wiejski (5)";6927;6928;6958;6950;1283;1270;1253;1221;4298;4298;4326;4334;2797;2770;2790;2788;1501;1528;1536;1546;1346;1360;1379;1395;
1419072;"Łąck (2)";5288;5321;5359;5365;1020;990;984;978;3419;3454;3469;3463;2192;2198;2196;2168;1227;1256;1273;1295;849;877;906;924;
1419082;"Mała Wieś (2)";6272;6236;6211;6177;1176;1123;1093;1070;3877;3881;3875;3857;2493;2511;2497;2458;1384;1370;1378;1399;1219;1232;1243;1250;
1419092;"Nowy Duninów (2)";3994;3996;3981;3964;747;744;727;705;2592;2590;2571;2557;1615;1608;1581;1575;977;982;990;982;655;662;683;702;
1419102;"Radzanowo (2)";8220;8252;8275;8324;1733;1700;1675;1647;5311;5322;5323;5350;3476;3508;3483;3473;1835;1814;1840;1877;1176;1230;1277;1327;
1419112;"Słubice (2)";4591;4567;4582;4542;917;872;874;834;2864;2868;2872;2840;1812;1833;1847;1827;1052;1035;1025;1013;810;827;836;868;
1419122;"Słupno (2)";6874;7031;7145;7259;1456;1439;1442;1453;4504;4612;4655;4685;2872;2927;2948;2968;1632;1685;1707;1717;914;980;1048;1121;
1419132;"Stara Biała (2)";11245;11423;11461;11611;2492;2492;2449;2421;7271;7398;7422;7540;4737;4832;4817;4845;2534;2566;2605;2695;1482;1533;1590;1650;
1419142;"Staroźreby (2)";7553;7503;7500;7432;1604;1537;1495;1424;4658;4651;4675;4674;3015;2999;3014;3007;1643;1652;1661;1667;1291;1315;1330;1334;
1419153;"Wyszogród (3)";5853;5786;5755;5707;1030;1012;999;996;3675;3596;3558;3515;2298;2245;2237;2218;1377;1351;1321;1297;1148;1178;1198;1196;
1419154;"Wyszogród - miasto (4)";2740;2709;2705;2697;474;468;460;465;1769;1721;1710;1689;1082;1055;1055;1042;687;666;655;647;497;520;535;543;
1419155;"Wyszogród - obszar wiejski (5)";3113;3077;3050;3010;556;544;539;531;1906;1875;1848;1826;1216;1190;1182;1176;690;685;666;650;651;658;663;653;
1420011;"Płońsk (1)";22597;22494;22379;22302;4187;4166;4137;4105;14723;14418;14128;13849;8919;8780;8661;8554;5804;5638;5467;5295;3687;3910;4114;4348;
1420021;"Raciąż (1)";4707;4662;4647;4544;943;909;879;829;3076;3036;3039;2975;1898;1858;1870;1814;1178;1178;1169;1161;688;717;729;740;
1420032;"Baboszewo (2)";8175;8138;8147;8101;1756;1705;1684;1646;5057;5057;5076;5034;3255;3247;3230;3213;1802;1810;1846;1821;1362;1376;1387;1421;
1420042;"Czerwińsk nad Wisłą (2)";7896;7914;7855;7814;1556;1531;1472;1446;4860;4838;4820;4763;3059;3081;3064;3060;1801;1757;1756;1703;1480;1545;1563;1605;
1420052;"Dzierzążnia (2)";3847;3809;3792;3773;755;722;708;698;2361;2353;2353;2336;1494;1501;1506;1497;867;852;847;839;731;734;731;739;
1420062;"Joniec (2)";2635;2614;2590;2607;505;497;478;475;1576;1563;1550;1556;946;932;916;922;630;631;634;634;554;554;562;576;
1420072;"Naruszewo (2)";6538;6504;6439;6439;1298;1261;1229;1230;4013;4012;3954;3944;2519;2538;2500;2496;1494;1474;1454;1448;1227;1231;1256;1265;
1420082;"Nowe Miasto (2)";4757;4724;4719;4696;862;842;804;783;3012;3003;3022;2986;1875;1869;1887;1881;1137;1134;1135;1105;883;879;893;927;
1420092;"Płońsk (2)";7548;7669;7724;7771;1601;1608;1607;1615;4777;4881;4914;4937;3082;3164;3161;3184;1695;1717;1753;1753;1170;1180;1203;1219;
1420102;"Raciąż (2)";8692;8707;8627;8585;1674;1649;1578;1555;5390;5414;5389;5338;3289;3322;3330;3305;2101;2092;2059;2033;1628;1644;1660;1692;
1420112;"Sochocin (2)";5910;5893;5936;5920;1111;1100;1138;1143;3766;3741;3708;3661;2344;2338;2333;2322;1422;1403;1375;1339;1033;1052;1090;1116;
1420122;"Załuski (2)";5723;5697;5728;5718;1201;1172;1167;1140;3582;3548;3582;3558;2242;2231;2250;2241;1340;1317;1332;1317;940;977;979;1020;
1421011;"Piastów (1)";22914;22826;22870;22927;3958;3954;3962;4019;14311;14003;13820;13650;8784;8701;8680;8646;5527;5302;5140;5004;4645;4869;5088;5258;
1421021;"Pruszków (1)";59025;59570;60068;60547;10609;10811;11063;11311;37004;37015;36854;36756;24025;24126;24149;24142;12979;12889;12705;12614;11412;11744;12151;12480;
1421033;"Brwinów (3)";24385;24775;25110;25438;4629;4790;4862;4963;15288;15355;15469;15567;9642;9744;9830;9935;5646;5611;5639;5632;4468;4630;4779;4908;
1421034;"Brwinów - miasto (4)";13002;13090;13178;13274;2419;2476;2493;2503;8065;8024;8027;8045;5089;5066;5082;5098;2976;2958;2945;2947;2518;2590;2658;2726;
1421035;"Brwinów - obszar wiejski (5)";11383;11685;11932;12164;2210;2314;2369;2460;7223;7331;7442;7522;4553;4678;4748;4837;2670;2653;2694;2685;1950;2040;2121;2182;
1421042;"Michałowice (2)";17031;17169;17307;17501;3496;3517;3550;3584;10588;10537;10496;10507;6383;6371;6347;6310;4205;4166;4149;4197;2947;3115;3261;3410;
1421052;"Nadarzyn (2)";12252;12499;12735;12870;2810;2802;2852;2878;7784;7937;8066;8087;4975;5073;5082;5068;2809;2864;2984;3019;1658;1760;1817;1905;
1421062;"Raszyn (2)";21200;21344;21425;21493;4182;4205;4205;4182;13313;13284;13231;13153;8245;8196;8147;8102;5068;5088;5084;5051;3705;3855;3989;4158;
1422011;"Przasnysz (1)";17430;17326;17296;17258;3425;3403;3375;3306;11156;10927;10747;10627;6662;6561;6483;6470;4494;4366;4264;4157;2849;2996;3174;3325;
1422023;"Chorzele (3)";10321;10235;10244;10256;2270;2168;2142;2149;6378;6408;6420;6402;4166;4168;4188;4158;2212;2240;2232;2244;1673;1659;1682;1705;
1422024;"Chorzele - miasto (4)";2981;2939;2972;3030;617;615;604;644;1880;1826;1840;1841;1200;1155;1180;1179;680;671;660;662;484;498;528;545;
1422025;"Chorzele - obszar wiejski (5)";7340;7296;7272;7226;1653;1553;1538;1505;4498;4582;4580;4561;2966;3013;3008;2979;1532;1569;1572;1582;1189;1161;1154;1160;
1422032;"Czernice Borowe (2)";3938;3933;3906;3886;762;752;727;720;2461;2465;2457;2429;1531;1524;1529;1511;930;941;928;918;715;716;722;737;
1422042;"Jednorożec (2)";7338;7309;7286;7221;1701;1633;1600;1550;4551;4571;4590;4574;2966;2985;2969;2966;1585;1586;1621;1608;1086;1105;1096;1097;
1422052;"Krasne (2)";3811;3783;3765;3730;767;756;742;730;2412;2383;2330;2294;1459;1445;1410;1378;953;938;920;916;632;644;693;706;
1422062;"Krzynowłoga Mała (2)";3603;3599;3576;3539;763;772;765;751;2244;2218;2201;2178;1409;1391;1378;1356;835;827;823;822;596;609;610;610;
1422072;"Przasnysz (2)";7350;7351;7366;7363;1618;1578;1574;1560;4518;4528;4539;4506;2884;2899;2909;2888;1634;1629;1630;1618;1214;1245;1253;1297;
1423012;"Borkowice (2)";4489;4453;4402;4330;796;761;766;750;2774;2764;2713;2656;1686;1687;1639;1606;1088;1077;1074;1050;919;928;923;924;
1423022;"Gielniów (2)";4662;4650;4673;4664;829;827;839;804;2849;2825;2803;2819;1746;1736;1708;1715;1103;1089;1095;1104;984;998;1031;1041;
1423032;"Klwów (2)";3479;3484;3468;3452;695;683;666;659;2075;2102;2109;2106;1308;1338;1340;1349;767;764;769;757;709;699;693;687;
1423042;"Odrzywół (2)";4028;3996;3973;3919;801;792;789;728;2416;2383;2360;2366;1503;1474;1448;1464;913;909;912;902;811;821;824;825;
1423052;"Potworów (2)";4300;4324;4299;4287;942;916;876;865;2635;2681;2702;2695;1698;1747;1767;1759;937;934;935;936;723;727;721;727;
1423063;"Przysucha (3)";12443;12209;12257;12176;2180;2045;2096;2043;7954;7798;7745;7633;4764;4643;4620;4531;3190;3155;3125;3102;2309;2366;2416;2500;
1423064;"Przysucha - miasto (4)";6236;6146;6068;6048;1032;1004;962;957;4170;4039;3957;3865;2399;2327;2287;2230;1771;1712;1670;1635;1034;1103;1149;1226;
1423065;"Przysucha - obszar wiejski (5)";6207;6063;6189;6128;1148;1041;1134;1086;3784;3759;3788;3768;2365;2316;2333;2301;1419;1443;1455;1467;1275;1263;1267;1274;
1423072;"Rusinów (2)";4391;4394;4379;4339;921;873;859;831;2629;2684;2677;2662;1692;1726;1717;1707;937;958;960;955;841;837;843;846;
1423082;"Wieniawa (2)";5479;5470;5437;5404;1097;1090;1058;1036;3389;3391;3376;3368;2202;2188;2195;2179;1187;1203;1181;1189;993;989;1003;1000;
1424012;"Gzy (2)";3952;3932;3914;3882;759;730;711;685;2446;2444;2439;2412;1523;1526;1533;1525;923;918;906;887;747;758;764;785;
1424022;"Obryte (2)";4891;4871;4860;4863;959;929;912;920;3010;3017;3007;2986;1868;1861;1839;1823;1142;1156;1168;1163;922;925;941;957;
1424032;"Pokrzywnica (2)";4878;4923;4944;4955;1039;1034;1035;1031;3058;3099;3104;3089;1952;1957;1974;1960;1106;1142;1130;1129;781;790;805;835;
1424043;"Pułtusk (3)";24062;24101;24148;24338;4724;4631;4600;4628;15527;15476;15386;15355;9756;9790;9791;9831;5771;5686;5595;5524;3811;3994;4162;4355;
1424044;"Pułtusk - miasto (4)";19191;19228;19236;19309;3662;3598;3591;3616;12494;12421;12272;12160;7799;7803;7748;7712;4695;4618;4524;4448;3035;3209;3373;3533;
1424045;"Pułtusk - obszar wiejski (5)";4871;4873;4912;5029;1062;1033;1009;1012;3033;3055;3114;3195;1957;1987;2043;2119;1076;1068;1071;1076;776;785;789;822;
1424052;"Świercze (2)";4694;4675;4678;4672;1009;983;947;919;2958;2961;2978;3004;1873;1871;1883;1905;1085;1090;1095;1099;727;731;753;749;
1424062;"Winnica (2)";4076;4079;4094;4107;874;885;898;888;2485;2471;2479;2493;1649;1632;1623;1644;836;839;856;849;717;723;717;726;
1424072;"Zatory (2)";4838;4814;4798;4820;1062;1030;989;997;2924;2942;2970;2977;1894;1894;1916;1925;1030;1048;1054;1052;852;842;839;846;
1425011;"Pionki (1)";19550;19382;19168;18938;3069;3022;2925;2841;12908;12587;12296;11970;7593;7482;7354;7238;5315;5105;4942;4732;3573;3773;3947;4127;
1425022;"Gózd (2)";8406;8477;8556;8636;1973;1939;1935;1939;5431;5532;5579;5610;3633;3704;3740;3742;1798;1828;1839;1868;1002;1006;1042;1087;
1425033;"Iłża (3)";15347;15286;15216;15056;2784;2740;2710;2631;9581;9511;9370;9219;5788;5801;5730;5646;3793;3710;3640;3573;2982;3035;3136;3206;
1425034;"Iłża - miasto (4)";5111;5054;4991;4947;861;839;822;798;3175;3114;3031;2974;1855;1835;1792;1763;1320;1279;1239;1211;1075;1101;1138;1175;
1425035;"Iłża - obszar wiejski (5)";10236;10232;10225;10109;1923;1901;1888;1833;6406;6397;6339;6245;3933;3966;3938;3883;2473;2431;2401;2362;1907;1934;1998;2031;
1425042;"Jastrzębia (2)";6732;6783;6830;6909;1532;1510;1503;1535;4259;4310;4330;4360;2775;2819;2867;2879;1484;1491;1463;1481;941;963;997;1014;
1425052;"Jedlińsk (2)";14064;14106;14163;14219;3277;3253;3225;3221;8915;8947;8966;8962;5928;5938;5945;5906;2987;3009;3021;3056;1872;1906;1972;2036;
1425062;"Jedlnia-Letnisko (2)";12348;12411;12475;12572;2601;2567;2537;2546;7977;8011;8015;8018;5170;5222;5241;5212;2807;2789;2774;2806;1770;1833;1923;2008;
1425072;"Kowala (2)";11679;11845;11891;11939;2861;2845;2775;2749;7319;7430;7479;7522;5014;5096;5134;5108;2305;2334;2345;2414;1499;1570;1637;1668;
1425082;"Pionki (2)";10075;10072;10040;10065;2122;2062;2018;1975;6356;6389;6378;6391;4143;4182;4136;4157;2213;2207;2242;2234;1597;1621;1644;1699;
1425092;"Przytyk (2)";7325;7313;7329;7321;1712;1667;1643;1614;4506;4550;4562;4543;2966;2985;2993;3017;1540;1565;1569;1526;1107;1096;1124;1164;
1425103;"Skaryszew (3)";14108;14251;14317;14382;3329;3309;3301;3265;8947;9056;9055;9098;5968;6095;6095;6124;2979;2961;2960;2974;1832;1886;1961;2019;
1425104;"Skaryszew - miasto (4)";4285;4308;4335;4334;982;959;972;969;2821;2849;2840;2820;1863;1898;1887;1878;958;951;953;942;482;500;523;545;
1425105;"Skaryszew - obszar wiejski (5)";9823;9943;9982;10048;2347;2350;2329;2296;6126;6207;6215;6278;4105;4197;4208;4246;2021;2010;2007;2032;1350;1386;1438;1474;
1425112;"Wierzbica (2)";10086;10059;9987;9937;2051;2034;1957;1922;6509;6441;6410;6369;4210;4193;4197;4186;2299;2248;2213;2183;1526;1584;1620;1646;
1425122;"Wolanów (2)";8631;8666;8755;8790;2062;2042;2034;2026;5444;5486;5548;5563;3659;3697;3735;3735;1785;1789;1813;1828;1125;1138;1173;1201;
1425132;"Zakrzew (2)";12317;12434;12594;12697;2962;2942;2938;2923;7851;7959;8052;8116;5274;5356;5420;5419;2577;2603;2632;2697;1504;1533;1604;1658;
1426012;"Domanice (2)";2685;2672;2660;2656;585;576;567;568;1662;1657;1650;1637;1104;1100;1084;1060;558;557;566;577;438;439;443;451;
1426022;"Korczew (2)";2881;2829;2796;2757;491;468;457;443;1695;1679;1659;1618;1020;1007;987;964;675;672;672;654;695;682;680;696;
1426032;"Kotuń (2)";8612;8606;8563;8515;1803;1784;1730;1684;5308;5318;5313;5292;3471;3477;3487;3463;1837;1841;1826;1829;1501;1504;1520;1539;
1426042;"Mokobody (2)";5114;5120;5092;5088;1048;1037;1016;1010;3101;3121;3120;3099;2013;2028;2024;1998;1088;1093;1096;1101;965;962;956;979;
1426053;"Mordy (3)";6154;6107;6017;6009;1168;1148;1092;1074;3755;3720;3694;3691;2389;2353;2321;2351;1366;1367;1373;1340;1231;1239;1231;1244;
1426054;"Mordy - miasto (4)";1833;1819;1797;1804;354;336;326;325;1203;1189;1174;1173;754;746;735;734;449;443;439;439;276;294;297;306;
1426055;"Mordy - obszar wiejski (5)";4321;4288;4220;4205;814;812;766;749;2552;2531;2520;2518;1635;1607;1586;1617;917;924;934;901;955;945;934;938;
1426062;"Paprotnia (2)";2722;2684;2675;2626;566;541;532;504;1616;1607;1600;1584;1039;1039;1032;1020;577;568;568;564;540;536;543;538;
1426072;"Przesmyki (2)";3554;3472;3414;3346;672;639;627;596;2050;2022;1976;1943;1258;1218;1211;1199;792;804;765;744;832;811;811;807;
1426082;"Siedlce (2)";17150;17315;17506;17628;3724;3738;3720;3656;11086;11161;11274;11317;7199;7222;7295;7339;3887;3939;3979;3978;2340;2416;2512;2655;
1426092;"Skórzec (2)";7649;7683;7696;7712;1744;1736;1711;1698;4745;4790;4813;4812;3214;3236;3239;3231;1531;1554;1574;1581;1160;1157;1172;1202;
1426102;"Suchożebry (2)";4771;4761;4730;4676;986;969;956;913;2912;2902;2880;2851;1885;1884;1852;1841;1027;1018;1028;1010;873;890;894;912;
1426112;"Wiśniew (2)";5888;5837;5815;5795;1386;1322;1259;1220;3596;3604;3629;3643;2326;2300;2314;2312;1270;1304;1315;1331;906;911;927;932;
1426122;"Wodynie (2)";4625;4594;4559;4503;915;875;874;827;2786;2815;2798;2783;1723;1745;1747;1742;1063;1070;1051;1041;924;904;887;893;
1426132;"Zbuczyn (2)";10119;10112;10067;10092;2297;2230;2194;2172;6061;6098;6107;6115;3955;4001;4019;3998;2106;2097;2088;2117;1761;1784;1766;1805;
1427011;"Sierpc (1)";18632;18491;18453;18317;3247;3248;3219;3144;12126;11840;11658;11439;7189;6995;6919;6811;4937;4845;4739;4628;3259;3403;3576;3734;
1427022;"Gozdowo (2)";6063;6032;6015;6008;1277;1208;1189;1164;3783;3802;3779;3777;2451;2435;2413;2394;1332;1367;1366;1383;1003;1022;1047;1067;
1427032;"Mochowo (2)";6149;6126;6135;6108;1378;1325;1291;1245;3830;3867;3913;3928;2482;2509;2521;2519;1348;1358;1392;1409;941;934;931;935;
1427042;"Rościszewo (2)";4288;4275;4248;4223;888;873;844;817;2622;2629;2641;2655;1681;1666;1666;1662;941;963;975;993;778;773;763;751;
1427052;"Sierpc (2)";7044;7071;7119;7107;1566;1552;1569;1528;4376;4410;4432;4442;2833;2826;2852;2863;1543;1584;1580;1579;1102;1109;1118;1137;
1427062;"Szczutowo (2)";4428;4412;4365;4338;925;885;850;828;2749;2760;2748;2763;1752;1737;1713;1709;997;1023;1035;1054;754;767;767;747;
1427072;"Zawidz (2)";6936;6919;6924;6879;1468;1426;1377;1342;4256;4250;4281;4273;2704;2706;2742;2724;1552;1544;1539;1549;1212;1243;1266;1264;
1428011;"Sochaczew (1)";37729;37480;37201;37102;6546;6420;6335;6355;24467;24029;23559;23213;14850;14614;14354;14216;9617;9415;9205;8997;6716;7031;7307;7534;
1428022;"Brochów (2)";4304;4290;4319;4308;831;818;811;804;2717;2690;2703;2681;1705;1689;1708;1706;1012;1001;995;975;756;782;805;823;
1428032;"Iłów (2)";6289;6273;6248;6236;1302;1287;1276;1259;3866;3834;3807;3796;2439;2428;2396;2379;1427;1406;1411;1417;1121;1152;1165;1181;
1428042;"Młodzieszyn (2)";5631;5607;5598;5589;1134;1100;1097;1084;3479;3467;3475;3463;2169;2165;2183;2175;1310;1302;1292;1288;1018;1040;1026;1042;
1428052;"Nowa Sucha (2)";6378;6451;6478;6519;1332;1337;1344;1346;4015;4061;4070;4073;2574;2613;2600;2604;1441;1448;1470;1469;1031;1053;1064;1100;
1428062;"Rybno (2)";3463;3471;3493;3453;726;721;727;711;2140;2152;2167;2136;1374;1390;1408;1406;766;762;759;730;597;598;599;606;
1428072;"Sochaczew (2)";10022;10253;10366;10491;2178;2216;2231;2238;6419;6544;6598;6668;4162;4270;4287;4329;2257;2274;2311;2339;1425;1493;1537;1585;
1428082;"Teresin (2)";11346;11330;11397;11469;2275;2243;2249;2261;7183;7166;7157;7179;4546;4524;4539;4543;2637;2642;2618;2636;1888;1921;1991;2029;
1429011;"Sokołów Podlaski (1)";18732;18720;18743;18763;3549;3530;3488;3466;12099;11944;11830;11691;7304;7237;7185;7137;4795;4707;4645;4554;3084;3246;3425;3606;
1429022;"Bielany (2)";3765;3731;3721;3695;751;738;731;716;2281;2245;2235;2214;1424;1401;1416;1413;857;844;819;801;733;748;755;765;
1429032;"Ceranów (2)";2370;2331;2316;2307;425;401;383;392;1375;1373;1366;1369;835;836;822;840;540;537;544;529;570;557;567;546;
1429042;"Jabłonna Lacka (2)";4842;4766;4704;4663;820;786;753;739;2919;2883;2867;2841;1796;1774;1742;1723;1123;1109;1125;1118;1103;1097;1084;1083;
1429053;"Kosów Lacki (3)";6536;6423;6363;6276;1201;1159;1127;1080;3933;3870;3837;3819;2413;2372;2351;2327;1520;1498;1486;1492;1402;1394;1399;1377;
1429054;"Kosów Lacki - miasto (4)";2197;2187;2152;2152;415;411;393;372;1411;1398;1373;1390;857;848;839;842;554;550;534;548;371;378;386;390;
1429055;"Kosów Lacki - obszar wiejski (5)";4339;4236;4211;4124;786;748;734;708;2522;2472;2464;2429;1556;1524;1512;1485;966;948;952;944;1031;1016;1013;987;
1429062;"Repki (2)";5675;5576;5502;5437;1056;1004;955;928;3349;3313;3287;3252;2042;2004;1996;1989;1307;1309;1291;1263;1270;1259;1260;1257;
1429072;"Sabnie (2)";3901;3870;3838;3808;672;653;629;619;2371;2352;2344;2303;1435;1420;1423;1411;936;932;921;892;858;865;865;886;
1429082;"Sokołów Podlaski (2)";6083;6088;6022;6061;1167;1139;1093;1096;3803;3806;3779;3779;2379;2389;2361;2378;1424;1417;1418;1401;1113;1143;1150;1186;
1429092;"Sterdyń (2)";4360;4307;4215;4142;747;710;677;658;2556;2552;2499;2445;1554;1558;1512;1471;1002;994;987;974;1057;1045;1039;1039;
1430012;"Chlewiska (2)";6183;6092;6102;6094;1117;1054;1034;1013;3807;3790;3803;3806;2321;2311;2334;2322;1486;1479;1469;1484;1259;1248;1265;1275;
1430022;"Jastrząb (2)";5232;5216;5228;5254;1118;1099;1075;1076;3285;3269;3296;3315;2152;2151;2167;2174;1133;1118;1129;1141;829;848;857;863;
1430032;"Mirów (2)";3904;3886;3876;3886;944;889;868;856;2355;2395;2410;2430;1595;1632;1639;1640;760;763;771;790;605;602;598;600;
1430042;"Orońsko (2)";5970;5968;5986;5982;1324;1304;1300;1294;3734;3739;3723;3724;2469;2481;2496;2504;1265;1258;1227;1220;912;925;963;964;
1430053;"Szydłowiec (3)";19349;19268;19147;19025;3623;3569;3482;3406;12510;12339;12160;11939;7838;7736;7681;7607;4672;4603;4479;4332;3216;3360;3505;3680;
1430054;"Szydłowiec - miasto (4)";12142;12064;12049;11940;2128;2085;2074;2026;8067;7913;7763;7561;4928;4841;4814;4759;3139;3072;2949;2802;1947;2066;2212;2353;
1430055;"Szydłowiec - obszar wiejski (5)";7207;7204;7098;7085;1495;1484;1408;1380;4443;4426;4397;4378;2910;2895;2867;2848;1533;1531;1530;1530;1269;1294;1293;1327;
1432013;"Błonie (3)";21025;21133;21216;21291;3820;3861;3892;3909;13133;13063;12974;12918;8050;8079;8064;8031;5083;4984;4910;4887;4072;4209;4350;4464;
1432014;"Błonie - miasto (4)";12602;12570;12479;12418;2214;2215;2191;2176;7724;7610;7484;7380;4699;4665;4605;4519;3025;2945;2879;2861;2664;2745;2804;2862;
1432015;"Błonie - obszar wiejski (5)";8423;8563;8737;8873;1606;1646;1701;1733;5409;5453;5490;5538;3351;3414;3459;3512;2058;2039;2031;2026;1408;1464;1546;1602;
1432022;"Izabelin (2)";10444;10523;10549;10526;2184;2154;2129;2090;6567;6598;6569;6499;3958;3945;3924;3891;2609;2653;2645;2608;1693;1771;1851;1937;
1432032;"Kampinos (2)";4245;4291;4320;4297;859;841;832;815;2646;2680;2681;2653;1693;1725;1705;1680;953;955;976;973;740;770;807;829;
1432042;"Leszno (2)";9846;9987;10017;10065;2057;2077;2056;2058;6291;6318;6313;6264;3964;4010;4004;3953;2327;2308;2309;2311;1498;1592;1648;1743;
1432053;"Łomianki (3)";24651;25013;25237;25543;5257;5330;5342;5337;15542;15588;15581;15632;9666;9721;9733;9716;5876;5867;5848;5916;3852;4095;4314;4574;
1432054;"Łomianki - miasto (4)";16600;16639;16617;16669;3267;3237;3215;3170;10442;10338;10202;10133;6394;6347;6276;6207;4048;3991;3926;3926;2891;3064;3200;3366;
1432055;"Łomianki - obszar wiejski (5)";8051;8374;8620;8874;1990;2093;2127;2167;5100;5250;5379;5499;3272;3374;3457;3509;1828;1876;1922;1990;961;1031;1114;1208;
1432063;"Ożarów Mazowiecki (3)";22024;22444;22797;23194;4143;4258;4401;4546;14110;14229;14333;14380;8854;9013;9177;9303;5256;5216;5156;5077;3771;3957;4063;4268;
1432064;"Ożarów Mazowiecki - miasto (4)";10378;10561;10880;10981;2078;2140;2230;2280;6500;6559;6684;6650;4225;4275;4390;4396;2275;2284;2294;2254;1800;1862;1966;2051;
1432065;"Ożarów Mazowiecki - obszar wiejski (5)";11646;11883;11917;12213;2065;2118;2171;2266;7610;7670;7649;7730;4629;4738;4787;4907;2981;2932;2862;2823;1971;2095;2097;2217;
1432072;"Stare Babice (2)";17389;17593;17763;18041;3718;3754;3775;3837;11041;11072;11102;11149;6767;6786;6783;6798;4274;4286;4319;4351;2630;2767;2886;3055;
1433011;"Węgrów (1)";12783;12796;12795;12781;2410;2354;2361;2341;8262;8187;8085;7989;5149;5131;5096;5047;3113;3056;2989;2942;2111;2255;2349;2451;
1433022;"Grębków (2)";4566;4553;4512;4457;904;915;897;881;2745;2719;2698;2659;1714;1697;1679;1663;1031;1022;1019;996;917;919;917;917;
1433032;"Korytnica (2)";6510;6464;6421;6388;1279;1263;1237;1209;3968;3944;3923;3910;2557;2525;2497;2509;1411;1419;1426;1401;1263;1257;1261;1269;
1433042;"Liw (2)";7603;7616;7583;7531;1471;1480;1447;1411;4767;4744;4701;4655;2980;2958;2949;2935;1787;1786;1752;1720;1365;1392;1435;1465;
1433053;"Łochów (3)";17960;17962;17956;17926;3732;3701;3646;3585;11303;11231;11192;11130;7253;7194;7192;7219;4050;4037;4000;3911;2925;3030;3118;3211;
1433054;"Łochów - miasto (4)";6748;6786;6809;6841;1379;1394;1383;1351;4392;4368;4351;4340;2806;2771;2765;2791;1586;1597;1586;1549;977;1024;1075;1150;
1433055;"Łochów - obszar wiejski (5)";11212;11176;11147;11085;2353;2307;2263;2234;6911;6863;6841;6790;4447;4423;4427;4428;2464;2440;2414;2362;1948;2006;2043;2061;
1433062;"Miedzna (2)";4069;4033;4005;3964;716;703;689;677;2533;2493;2451;2421;1523;1502;1491;1481;1010;991;960;940;820;837;865;866;
1433072;"Sadowne (2)";6109;6066;6023;5961;1186;1149;1136;1123;3765;3749;3707;3641;2365;2335;2333;2274;1400;1414;1374;1367;1158;1168;1180;1197;
1433082;"Stoczek (2)";5224;5176;5169;5112;1012;994;1003;964;3190;3139;3092;3066;2054;2026;2009;1988;1136;1113;1083;1078;1022;1043;1074;1082;
1433092;"Wierzbno (2)";3006;2930;2896;2885;531;492;484;500;1805;1777;1759;1742;1086;1064;1046;1038;719;713;713;704;670;661;653;643;
1434011;"Kobyłka (1)";20458;20855;21341;21890;4330;4401;4554;4720;13187;13381;13544;13766;8498;8675;8785;8967;4689;4706;4759;4799;2941;3073;3243;3404;
1434021;"Marki (1)";28288;29032;29722;30595;6719;6867;7034;7219;18125;18525;18864;19321;12350;12628;12869;13163;5775;5897;5995;6158;3444;3640;3824;4055;
1434031;"Ząbki (1)";30879;31884;32844;33818;7456;7738;7935;8316;19818;20376;20965;21402;14530;14972;15349;15593;5288;5404;5616;5809;3605;3770;3944;4100;
1434041;"Zielonka (1)";17394;17398;17459;17488;3386;3324;3326;3309;10552;10521;10514;10488;6627;6614;6555;6505;3925;3907;3959;3983;3456;3553;3619;3691;
1434052;"Dąbrówka (2)";7714;7772;7839;7925;1772;1760;1748;1777;4848;4892;4932;4940;3166;3220;3234;3283;1682;1672;1698;1657;1094;1120;1159;1208;
1434062;"Jadów (2)";7731;7708;7666;7612;1520;1495;1488;1449;4848;4842;4787;4756;3033;3052;3038;3005;1815;1790;1749;1751;1363;1371;1391;1407;
1434072;"Klembów (2)";9411;9493;9562;9628;2095;2117;2123;2148;5912;5943;5968;5965;3831;3873;3892;3916;2081;2070;2076;2049;1404;1433;1471;1515;
1434082;"Poświętne (2)";6052;6081;6137;6154;1331;1327;1354;1364;3885;3916;3943;3928;2548;2555;2580;2575;1337;1361;1363;1353;836;838;840;862;
1434093;"Radzymin (3)";23959;24548;25051;25663;5538;5690;5872;6027;15393;15688;15892;16096;10278;10557;10760;10921;5115;5131;5132;5175;3028;3170;3287;3540;
1434094;"Radzymin - miasto (4)";10993;11378;11698;12057;2510;2645;2771;2899;6981;7175;7342;7454;4796;4988;5117;5196;2185;2187;2225;2258;1502;1558;1585;1704;
1434095;"Radzymin - obszar wiejski (5)";12966;13170;13353;13606;3028;3045;3101;3128;8412;8513;8550;8642;5482;5569;5643;5725;2930;2944;2907;2917;1526;1612;1702;1836;
1434102;"Strachówka (2)";2854;2837;2800;2779;549;544;518;510;1749;1730;1716;1698;1111;1104;1099;1099;638;626;617;599;556;563;566;571;
1434113;"Tłuszcz (3)";19431;19551;19667;19782;4198;4184;4194;4204;12565;12565;12548;12491;8193;8205;8184;8158;4372;4360;4364;4333;2668;2802;2925;3087;
1434114;"Tłuszcz - miasto (4)";7960;7989;8041;8055;1653;1658;1673;1695;5271;5209;5173;5093;3337;3299;3292;3249;1934;1910;1881;1844;1036;1122;1195;1267;
1434115;"Tłuszcz - obszar wiejski (5)";11471;11562;11626;11727;2545;2526;2521;2509;7294;7356;7375;7398;4856;4906;4892;4909;2438;2450;2483;2489;1632;1680;1730;1820;
1434123;"Wołomin (3)";51484;51671;51669;51709;10108;10165;10089;10122;32861;32546;32273;31889;20923;20762;20639;20430;11938;11784;11634;11459;8515;8960;9307;9698;
1434124;"Wołomin - miasto (4)";37459;37505;37389;37318;6974;7016;6942;6982;23740;23391;23098;22708;15013;14831;14708;14469;8727;8560;8390;8239;6745;7098;7349;7628;
1434125;"Wołomin - obszar wiejski (5)";14025;14166;14280;14391;3134;3149;3147;3140;9121;9155;9175;9181;5910;5931;5931;5961;3211;3224;3244;3220;1770;1862;1958;2070;
1435012;"Brańszczyk (2)";8448;8428;8397;8380;1653;1601;1573;1574;5212;5218;5211;5199;3311;3310;3287;3273;1901;1908;1924;1926;1583;1609;1613;1607;
1435022;"Długosiodło (2)";7956;7922;7893;7887;1772;1708;1685;1645;4839;4842;4823;4826;3165;3165;3133;3128;1674;1677;1690;1698;1345;1372;1385;1416;
1435032;"Rząśnik (2)";6926;6965;6997;7012;1580;1583;1561;1533;4293;4309;4344;4361;2815;2813;2833;2833;1478;1496;1511;1528;1053;1073;1092;1118;
1435042;"Somianka (2)";5594;5591;5563;5590;1221;1174;1162;1164;3389;3417;3407;3418;2196;2228;2204;2221;1193;1189;1203;1197;984;1000;994;1008;
1435053;"Wyszków (3)";39075;39161;39172;39209;8020;7997;7924;7911;25407;25289;25187;24975;16215;16099;16009;15909;9192;9190;9178;9066;5648;5875;6061;6323;
1435054;"Wyszków - miasto (4)";27309;27222;27173;27075;5423;5363;5291;5256;17967;17738;17589;17322;11256;11102;11016;10871;6711;6636;6573;6451;3919;4121;4293;4497;
1435055;"Wyszków - obszar wiejski (5)";11766;11939;11999;12134;2597;2634;2633;2655;7440;7551;7598;7653;4959;4997;4993;5038;2481;2554;2605;2615;1729;1754;1768;1826;
1435062;"Zabrodzie (2)";5818;5847;5870;5873;1292;1297;1295;1288;3660;3657;3665;3649;2456;2448;2433;2411;1204;1209;1232;1238;866;893;910;936;
1436012;"Kazanów (2)";4652;4652;4637;4588;1022;985;972;940;2823;2857;2842;2827;1807;1830;1812;1800;1016;1027;1030;1027;807;810;823;821;
1436022;"Policzna (2)";5766;5747;5732;5685;1020;991;971;941;3630;3640;3627;3615;2223;2234;2213;2209;1407;1406;1414;1406;1116;1116;1134;1129;
1436032;"Przyłęk (2)";6366;6349;6352;6314;1261;1242;1234;1218;3870;3868;3864;3831;2445;2462;2470;2448;1425;1406;1394;1383;1235;1239;1254;1265;
1436042;"Tczów (2)";4880;4877;4879;4884;1078;1069;1057;1044;3080;3082;3087;3083;2023;2042;2035;2045;1057;1040;1052;1038;722;726;735;757;
1436053;"Zwoleń (3)";15405;15342;15319;15290;3004;2917;2882;2804;9770;9718;9645;9596;6199;6152;6108;6076;3571;3566;3537;3520;2631;2707;2792;2890;
1436054;"Zwoleń - miasto (4)";8211;8112;8065;7944;1515;1458;1411;1332;5259;5161;5094;5012;3265;3174;3139;3062;1994;1987;1955;1950;1437;1493;1560;1600;
1436055;"Zwoleń - obszar wiejski (5)";7194;7230;7254;7346;1489;1459;1471;1472;4511;4557;4551;4584;2934;2978;2969;3014;1577;1579;1582;1570;1194;1214;1232;1290;
1437013;"Bieżuń (3)";5302;5246;5208;5181;1060;995;965;926;3239;3240;3237;3250;2051;2049;2034;2065;1188;1191;1203;1185;1003;1011;1006;1005;
1437014;"Bieżuń - miasto (4)";1932;1911;1890;1901;352;334;326;317;1251;1247;1237;1249;782;775;761;775;469;472;476;474;329;330;327;335;
1437015;"Bieżuń - obszar wiejski (5)";3370;3335;3318;3280;708;661;639;609;1988;1993;2000;2001;1269;1274;1273;1290;719;719;727;711;674;681;679;670;
1437022;"Kuczbork-Osada (2)";4915;4871;4898;4863;1021;979;977;951;2969;2967;2987;2960;1846;1843;1876;1857;1123;1124;1111;1103;925;925;934;952;
1437032;"Lubowidz (2)";7162;7108;7096;7067;1456;1412;1395;1347;4321;4304;4284;4302;2733;2713;2708;2719;1588;1591;1576;1583;1385;1392;1417;1418;
1437042;"Lutocin (2)";4538;4505;4425;4416;967;945;891;893;2650;2626;2593;2579;1712;1677;1653;1639;938;949;940;940;921;934;941;944;
1437052;"Siemiątkowo (2)";3643;3587;3563;3563;777;743;724;714;2216;2195;2181;2179;1426;1418;1399;1390;790;777;782;789;650;649;658;670;
1437063;"Żuromin (3)";14740;14697;14676;14646;2839;2753;2691;2652;9521;9489;9424;9340;5830;5821;5794;5719;3691;3668;3630;3621;2380;2455;2561;2654;
1437064;"Żuromin - miasto (4)";9016;9022;9015;8997;1604;1573;1552;1531;6096;6061;6000;5926;3652;3645;3624;3564;2444;2416;2376;2362;1316;1388;1463;1540;
1437065;"Żuromin - obszar wiejski (5)";5724;5675;5661;5649;1235;1180;1139;1121;3425;3428;3424;3414;2178;2176;2170;2155;1247;1252;1254;1259;1064;1067;1098;1114;
1438011;"Żyrardów (1)";41318;41096;41003;40652;7439;7350;7382;7401;26027;25599;25186;24571;16008;15867;15743;15449;10019;9732;9443;9122;7852;8147;8435;8680;
1438023;"Mszczonów (3)";11611;11599;11575;11552;2362;2300;2276;2262;7276;7255;7232;7150;4614;4622;4610;4570;2662;2633;2622;2580;1973;2044;2067;2140;
1438024;"Mszczonów - miasto (4)";6432;6460;6445;6419;1201;1197;1186;1192;4120;4092;4055;3978;2573;2580;2567;2526;1547;1512;1488;1452;1111;1171;1204;1249;
1438025;"Mszczonów - obszar wiejski (5)";5179;5139;5130;5133;1161;1103;1090;1070;3156;3163;3177;3172;2041;2042;2043;2044;1115;1121;1134;1128;862;873;863;891;
1438032;"Puszcza Mariańska (2)";8469;8456;8484;8545;1587;1557;1585;1577;5324;5318;5254;5269;3299;3292;3276;3279;2025;2026;1978;1990;1558;1581;1645;1699;
1438042;"Radziejowice (2)";5318;5411;5483;5547;1085;1120;1106;1133;3412;3441;3488;3469;2116;2138;2183;2180;1296;1303;1305;1289;821;850;889;945;
1438052;"Wiskitki (2)";9857;9829;9875;9842;1992;1954;1895;1877;6211;6197;6221;6185;3843;3814;3805;3798;2368;2383;2416;2387;1654;1678;1759;1780;
1461011;"Ostrołęka (1)";53287;52917;52611;52571;9831;9776;9636;9629;35445;34596;33958;33322;21443;20965;20583;20346;14002;13631;13375;12976;8011;8545;9017;9620;
1462011;"Płock (1)";123627;122815;122224;121731;21233;21051;20896;20771;79178;77537;76164;74692;49100;48189;47487;46751;30078;29348;28677;27941;23216;24227;25164;26268;
1463011;"Radom (1)";219703;218466;217201;216159;38576;38003;37472;37131;140117;138086;135924;133827;86412;85516;84516;83468;53705;52570;51408;50359;41010;42377;43805;45201;
1464011;"Siedlce (1)";76393;76347;76603;76942;14366;14490;14641;14903;49379;48446;47800;47187;31226;30879;30669;30486;18153;17567;17131;16701;12648;13411;14162;14852;
1465011;"M.st.Warszawa od 2002 (1)";1715517;1724404;1735442;1744351;270387;275960;283370;291837;1067975;1061842;1055936;1046632;683131;687018;689931;688268;384844;374824;366005;358364;377155;386602;396136;405882;
1465028;"Bemowo - dzielnica (8)";116676;116382;118057;119113;19534;20220;21076;21762;75767;73265;72482;71333;50606;49459;49779;49640;25161;23806;22703;21693;21375;22897;24499;26018;
1465038;"Białołęka - dzielnica (8)";100226;104649;109062;112845;24447;25644;27063;28355;67536;69847;71928;73429;49379;51440;53114;54168;18157;18407;18814;19261;8243;9158;10071;11061;
1465048;"Bielany - dzielnica (8)";132366;132240;131934;131919;19412;19628;19920;20249;79708;78670;77559;76362;49474;49454;49081;48610;30234;29216;28478;27752;33246;33942;34455;35308;
1465058;"Mokotów - dzielnica (8)";219812;219373;218911;218042;29627;30065;30856;31632;130911;129607;127863;125807;82732;82573;82121;81140;48179;47034;45742;44667;59274;59701;60192;60603;
1465068;"Ochota - dzielnica (8)";84614;84594;84280;84077;11194;11337;11513;11836;51625;51513;51026;50543;32334;32582;32447;32226;19291;18931;18579;18317;21795;21744;21741;21698;
1465078;"Praga-Południe - dzielnica (8)";178662;178170;178309;178267;25701;26000;26436;26923;112117;110353;108967;107305;68802;68659;68671;68318;43315;41694;40296;38987;40844;41817;42906;44039;
1465088;"Praga-Północ - dzielnica (8)";68699;67984;67279;66495;10572;10322;10196;10107;44360;43566;42703;41649;27381;27087;26712;26227;16979;16479;15991;15422;13767;14096;14380;14739;
1465098;"Rembertów - dzielnica (8)";23441;23618;23812;23964;4212;4271;4356;4423;15322;15223;15154;15022;9588;9562;9603;9566;5734;5661;5551;5456;3907;4124;4302;4519;
1465108;"Śródmieście - dzielnica (8)";121570;121163;120091;119193;13760;13789;13851;14215;73704;73262;72058;70904;44503;44906;44731;44407;29201;28356;27327;26497;34106;34112;34182;34074;
1465118;"Targówek - dzielnica (8)";123464;123705;123677;123441;19931;20037;20155;20337;74156;73524;72735;71823;48265;48223;47790;47101;25891;25301;24945;24722;29377;30144;30787;31281;
1465128;"Ursus - dzielnica (8)";54745;55598;56490;57237;11087;11458;11800;12216;34055;34353;34636;34743;24136;24403;24634;24661;9919;9950;10002;10082;9603;9787;10054;10278;
1465138;"Ursynów - dzielnica (8)";146895;147611;148385;149167;25729;26252;26802;27406;96314;94188;92279;90260;62727;62432;62076;61412;33587;31756;30203;28848;24852;27171;29304;31501;
1465148;"Wawer - dzielnica (8)";70846;71762;72921;73923;13294;13632;14006;14476;43738;43925;44241;44322;26574;26813;27166;27331;17164;17112;17075;16991;13814;14205;14674;15125;
1465158;"Wesoła - dzielnica (8)";23265;23715;24073;24451;5015;5064;5114;5204;14855;15073;15156;15221;9493;9637;9708;9723;5362;5436;5448;5498;3395;3578;3803;4026;
1465168;"Wilanów - dzielnica (8)";26011;28314;30703;32794;5917;6673;7540;8385;16380;17630;18889;19878;11871;13042;14124;14874;4509;4588;4765;5004;3714;4011;4274;4531;
1465178;"Włochy - dzielnica (8)";38278;39056;39940;40857;6525;6752;7013;7474;23945;24314;24758;24977;14915;15308;15798;16087;9030;9006;8960;8890;7808;7990;8169;8406;
1465188;"Wola - dzielnica (8)";137651;138001;138462;138517;17954;18230;18764;19466;85120;85092;84841;83979;52560;53384;53975;53812;32560;31708;30866;30167;34577;34679;34857;35072;
1465198;"Żoliborz - dzielnica (8)";48296;48469;49056;50049;6476;6586;6909;7371;28362;28437;28661;29075;17791;18054;18401;18965;10571;10383;10260;10110;13458;13446;13486;13603;
1601011;"Brzeg (1)";37261;36980;36675;36469;6282;6137;6038;5964;23604;23180;22734;22365;14263;14121;13901;13758;9341;9059;8833;8607;7375;7663;7903;8140;
1601022;"Skarbimierz (2)";7652;7791;7852;7928;1630;1632;1589;1596;4997;5096;5157;5178;3286;3312;3353;3343;1711;1784;1804;1835;1025;1063;1106;1154;
1601033;"Grodków (3)";19826;19699;19620;19511;3822;3684;3602;3522;12804;12669;12541;12365;7878;7865;7812;7762;4926;4804;4729;4603;3200;3346;3477;3624;
1601034;"Grodków - miasto (4)";8900;8871;8816;8776;1566;1535;1492;1480;5794;5709;5616;5523;3514;3493;3434;3381;2280;2216;2182;2142;1540;1627;1708;1773;
1601035;"Grodków - obszar wiejski (5)";10926;10828;10804;10735;2256;2149;2110;2042;7010;6960;6925;6842;4364;4372;4378;4381;2646;2588;2547;2461;1660;1719;1769;1851;
1601043;"Lewin Brzeski (3)";13594;13498;13389;13299;2675;2568;2495;2376;8787;8732;8619;8583;5521;5515;5445;5428;3266;3217;3174;3155;2132;2198;2275;2340;
1601044;"Lewin Brzeski - miasto (4)";6089;6007;5940;5904;1198;1113;1077;1030;3937;3890;3830;3805;2452;2446;2397;2393;1485;1444;1433;1412;954;1004;1033;1069;
1601045;"Lewin Brzeski - obszar wiejski (5)";7505;7491;7449;7395;1477;1455;1418;1346;4850;4842;4789;4778;3069;3069;3048;3035;1781;1773;1741;1743;1178;1194;1242;1271;
1601052;"Lubsza (2)";9004;9052;9026;9028;1679;1686;1637;1615;5886;5866;5826;5786;3595;3607;3591;3576;2291;2259;2235;2210;1439;1500;1563;1627;
1601062;"Olszanka (2)";5008;4961;4981;4956;967;925;923;916;3221;3193;3194;3158;2042;2025;2024;1999;1179;1168;1170;1159;820;843;864;882;
1602013;"Baborów (3)";6281;6192;6170;6151;1044;994;986;968;4149;4114;4090;4078;2486;2426;2405;2389;1663;1688;1685;1689;1088;1084;1094;1105;
1602014;"Baborów - miasto (4)";3088;3005;3009;2964;506;465;463;441;2055;2013;2003;1970;1232;1176;1176;1144;823;837;827;826;527;527;543;553;
1602015;"Baborów - obszar wiejski (5)";3193;3187;3161;3187;538;529;523;527;2094;2101;2087;2108;1254;1250;1229;1245;840;851;858;863;561;557;551;552;
1602022;"Branice (2)";6961;6825;6799;6744;1089;1038;1006;976;4462;4336;4276;4231;2581;2486;2420;2384;1881;1850;1856;1847;1410;1451;1517;1537;
1602033;"Głubczyce (3)";23270;23144;23012;22776;4060;3987;3899;3778;14681;14470;14273;14079;8787;8713;8611;8553;5894;5757;5662;5526;4529;4687;4840;4919;
1602034;"Głubczyce - miasto (4)";13052;12990;12911;12799;2271;2234;2184;2131;8120;7971;7858;7760;4947;4915;4837;4805;3173;3056;3021;2955;2661;2785;2869;2908;
1602035;"Głubczyce - obszar wiejski (5)";10218;10154;10101;9977;1789;1753;1715;1647;6561;6499;6415;6319;3840;3798;3774;3748;2721;2701;2641;2571;1868;1902;1971;2011;
1602043;"Kietrz (3)";11384;11292;11281;11221;2015;1934;1885;1841;7312;7252;7231;7175;4475;4481;4486;4449;2837;2771;2745;2726;2057;2106;2165;2205;
1602044;"Kietrz - miasto (4)";6195;6136;6167;6118;1069;1027;996;968;3978;3926;3939;3890;2439;2441;2456;2422;1539;1485;1483;1468;1148;1183;1232;1260;
1602045;"Kietrz - obszar wiejski (5)";5189;5156;5114;5103;946;907;889;873;3334;3326;3292;3285;2036;2040;2030;2027;1298;1286;1262;1258;909;923;933;945;
1603011;"Kędzierzyn-Koźle (1)";63635;63194;62840;62399;10102;9845;9682;9488;40618;40049;39508;38949;24655;24266;23810;23333;15963;15783;15698;15616;12915;13300;13650;13962;
1603022;"Bierawa (2)";7811;7809;7829;7866;1224;1222;1241;1246;5119;5087;5072;5053;3018;2984;2969;2935;2101;2103;2103;2118;1468;1500;1516;1567;
1603032;"Cisek (2)";5922;5830;5790;5750;957;937;916;891;3841;3777;3760;3734;2364;2301;2242;2205;1477;1476;1518;1529;1124;1116;1114;1125;
1603042;"Pawłowiczki (2)";7957;7835;7802;7719;1341;1296;1254;1229;5163;5087;5077;5019;3150;3053;3022;2996;2013;2034;2055;2023;1453;1452;1471;1471;
1603052;"Polska Cerekiew (2)";4311;4265;4213;4156;634;623;602;580;2824;2792;2750;2702;1657;1619;1596;1571;1167;1173;1154;1131;853;850;861;874;
1603062;"Reńska Wieś (2)";8243;8248;8241;8249;1354;1342;1334;1318;5406;5402;5388;5400;3253;3217;3181;3188;2153;2185;2207;2212;1483;1504;1519;1531;
1604013;"Byczyna (3)";9533;9546;9529;9513;1813;1800;1750;1710;6218;6190;6173;6137;3857;3838;3825;3819;2361;2352;2348;2318;1502;1556;1606;1666;
1604014;"Byczyna - miasto (4)";3722;3714;3678;3658;641;634;609;598;2498;2473;2429;2388;1532;1511;1482;1459;966;962;947;929;583;607;640;672;
1604015;"Byczyna - obszar wiejski (5)";5811;5832;5851;5855;1172;1166;1141;1112;3720;3717;3744;3749;2325;2327;2343;2360;1395;1390;1401;1389;919;949;966;994;
1604023;"Kluczbork (3)";36925;36781;36605;36406;5863;5787;5698;5621;24156;23906;23589;23242;14875;14686;14469;14268;9281;9220;9120;8974;6906;7088;7318;7543;
1604024;"Kluczbork - miasto (4)";24707;24544;24410;24207;3765;3704;3675;3660;16071;15811;15535;15198;9776;9625;9455;9246;6295;6186;6080;5952;4871;5029;5200;5349;
1604025;"Kluczbork - obszar wiejski (5)";12218;12237;12195;12199;2098;2083;2023;1961;8085;8095;8054;8044;5099;5061;5014;5022;2986;3034;3040;3022;2035;2059;2118;2194;
1604032;"Lasowice Wielkie (2)";7012;6963;6930;6949;1104;1052;1025;1007;4669;4672;4656;4673;2941;2930;2893;2877;1728;1742;1763;1796;1239;1239;1249;1269;
1604043;"Wołczyn (3)";14088;13966;13913;13839;2528;2427;2344;2288;9133;9046;9025;8956;5746;5701;5702;5642;3387;3345;3323;3314;2427;2493;2544;2595;
1604044;"Wołczyn - miasto (4)";6068;5986;5967;5947;1014;967;931;914;3949;3871;3860;3839;2498;2454;2433;2414;1451;1417;1427;1425;1105;1148;1176;1194;
1604045;"Wołczyn - obszar wiejski (5)";8020;7980;7946;7892;1514;1460;1413;1374;5184;5175;5165;5117;3248;3247;3269;3228;1936;1928;1896;1889;1322;1345;1368;1401;
1605013;"Gogolin (3)";12405;12464;12442;12436;2018;2011;2007;2005;8202;8265;8231;8185;4973;4960;4849;4802;3229;3305;3382;3383;2185;2188;2204;2246;
1605014;"Gogolin - miasto (4)";6512;6538;6529;6564;1087;1097;1094;1109;4324;4328;4287;4274;2622;2611;2553;2545;1702;1717;1734;1729;1101;1113;1148;1181;
1605015;"Gogolin - obszar wiejski (5)";5893;5926;5913;5872;931;914;913;896;3878;3937;3944;3911;2351;2349;2296;2257;1527;1588;1648;1654;1084;1075;1056;1065;
1605023;"Krapkowice (3)";23549;23326;23252;23148;3746;3622;3598;3523;15444;15205;14937;14735;9426;9264;9067;8939;6018;5941;5870;5796;4359;4499;4717;4890;
1605024;"Krapkowice - miasto (4)";17137;16924;16851;16789;2663;2544;2529;2486;11365;11130;10884;10687;6894;6758;6605;6521;4471;4372;4279;4166;3109;3250;3438;3616;
1605025;"Krapkowice - obszar wiejski (5)";6412;6402;6401;6359;1083;1078;1069;1037;4079;4075;4053;4048;2532;2506;2462;2418;1547;1569;1591;1630;1250;1249;1279;1274;
1605032;"Strzeleczki (2)";7511;7508;7468;7425;1224;1217;1181;1158;4912;4943;4919;4897;3079;3064;3015;2955;1833;1879;1904;1942;1375;1348;1368;1370;
1605042;"Walce (2)";5622;5602;5580;5550;901;888;869;868;3675;3671;3663;3641;2230;2206;2189;2147;1445;1465;1474;1494;1046;1043;1048;1041;
1605053;"Zdzieszowice (3)";16303;16213;16108;16040;2737;2671;2604;2545;11066;10887;10680;10552;6710;6619;6493;6429;4356;4268;4187;4123;2500;2655;2824;2943;
1605054;"Zdzieszowice - miasto (4)";12087;11978;11899;11801;2024;1971;1923;1878;8336;8136;7945;7784;5054;4951;4855;4780;3282;3185;3090;3004;1727;1871;2031;2139;
1605055;"Zdzieszowice - obszar wiejski (5)";4216;4235;4209;4239;713;700;681;667;2730;2751;2735;2768;1656;1668;1638;1649;1074;1083;1097;1119;773;784;793;804;
1606012;"Domaszowice (2)";3718;3680;3687;3647;725;709;706;689;2387;2341;2328;2289;1416;1395;1409;1401;971;946;919;888;606;630;653;669;
1606023;"Namysłów (3)";25718;25700;25772;25749;4531;4501;4549;4463;16573;16410;16286;16155;10141;10103;10102;10097;6432;6307;6184;6058;4614;4789;4937;5131;
1606024;"Namysłów - miasto (4)";16138;16123;16126;16105;2650;2646;2688;2637;10383;10254;10104;9971;6294;6265;6222;6202;4089;3989;3882;3769;3105;3223;3334;3497;
1606025;"Namysłów - obszar wiejski (5)";9580;9577;9646;9644;1881;1855;1861;1826;6190;6156;6182;6184;3847;3838;3880;3895;2343;2318;2302;2289;1509;1566;1603;1634;
1606032;"Pokój (2)";5407;5324;5305;5284;990;951;930;904;3630;3554;3533;3487;2243;2183;2157;2133;1387;1371;1376;1354;787;819;842;893;
1606042;"Świerczów (2)";3542;3547;3480;3429;617;626;595;580;2332;2301;2249;2205;1410;1405;1373;1353;922;896;876;852;593;620;636;644;
1606052;"Wilków (2)";4626;4630;4565;4506;971;968;918;896;3010;3012;2981;2939;1887;1879;1859;1809;1123;1133;1122;1130;645;650;666;671;
1607013;"Głuchołazy (3)";25018;24726;24493;24254;4073;3859;3777;3676;16107;15878;15640;15380;9715;9630;9527;9408;6392;6248;6113;5972;4838;4989;5076;5198;
1607014;"Głuchołazy - miasto (4)";14382;14257;14092;13925;2219;2146;2089;2031;9212;9035;8851;8652;5465;5406;5337;5250;3747;3629;3514;3402;2951;3076;3152;3242;
1607015;"Głuchołazy - obszar wiejski (5)";10636;10469;10401;10329;1854;1713;1688;1645;6895;6843;6789;6728;4250;4224;4190;4158;2645;2619;2599;2570;1887;1913;1924;1956;
1607022;"Kamiennik (2)";3681;3630;3611;3570;686;652;627;612;2388;2362;2370;2314;1485;1466;1478;1424;903;896;892;890;607;616;614;644;
1607033;"Korfantów (3)";9274;9242;9164;9121;1656;1608;1564;1510;6147;6150;6084;6075;3837;3823;3765;3751;2310;2327;2319;2324;1471;1484;1516;1536;
1607034;"Korfantów - miasto (4)";1910;1893;1881;1875;281;268;269;270;1266;1248;1225;1216;775;763;742;742;491;485;483;474;363;377;387;389;
1607035;"Korfantów - obszar wiejski (5)";7364;7349;7283;7246;1375;1340;1295;1240;4881;4902;4859;4859;3062;3060;3023;3009;1819;1842;1836;1850;1108;1107;1129;1147;
1607042;"Łambinowice (2)";7864;7775;7734;7697;1417;1361;1318;1289;5095;4999;4948;4913;3191;3155;3112;3084;1904;1844;1836;1829;1352;1415;1468;1495;
1607053;"Nysa (3)";58397;58132;57996;57710;9228;9037;8892;8730;37727;37175;36644;36115;22665;22469;22239;22023;15062;14706;14405;14092;11442;11920;12460;12865;
1607054;"Nysa - miasto (4)";45232;44899;44775;44500;6727;6584;6479;6354;29124;28537;28074;27597;17265;17002;16801;16601;11859;11535;11273;10996;9381;9778;10222;10549;
1607055;"Nysa - obszar wiejski (5)";13165;13233;13221;13210;2501;2453;2413;2376;8603;8638;8570;8518;5400;5467;5438;5422;3203;3171;3132;3096;2061;2142;2238;2316;
1607063;"Otmuchów (3)";14063;13903;13890;13803;2547;2460;2423;2338;9059;8941;8836;8767;5529;5484;5463;5425;3530;3457;3373;3342;2457;2502;2631;2698;
1607064;"Otmuchów - miasto (4)";5137;5068;5038;5000;856;821;807;768;3309;3261;3194;3163;1984;1971;1935;1921;1325;1290;1259;1242;972;986;1037;1069;
1607065;"Otmuchów - obszar wiejski (5)";8926;8835;8852;8803;1691;1639;1616;1570;5750;5680;5642;5604;3545;3513;3528;3504;2205;2167;2114;2100;1485;1516;1594;1629;
1607073;"Paczków (3)";13198;13161;13097;12945;2339;2261;2194;2110;8566;8477;8357;8238;5179;5168;5157;5123;3387;3309;3200;3115;2293;2423;2546;2597;
1607074;"Paczków - miasto (4)";7898;7865;7785;7689;1332;1275;1226;1197;5097;5019;4907;4838;3003;2996;2978;2956;2094;2023;1929;1882;1469;1571;1652;1654;
1607075;"Paczków - obszar wiejski (5)";5300;5296;5312;5256;1007;986;968;913;3469;3458;3450;3400;2176;2172;2179;2167;1293;1286;1271;1233;824;852;894;943;
1607082;"Pakosławice (2)";3674;3672;3641;3582;603;600;561;525;2488;2467;2473;2442;1581;1548;1540;1499;907;919;933;943;583;605;607;615;
1607092;"Skoroszyce (2)";6417;6387;6341;6287;1250;1227;1171;1151;4196;4166;4157;4083;2550;2534;2544;2525;1646;1632;1613;1558;971;994;1013;1053;
1608013;"Dobrodzień (3)";10065;10051;10030;10003;1677;1650;1644;1608;6556;6551;6506;6460;4009;3955;3868;3809;2547;2596;2638;2651;1832;1850;1880;1935;
1608014;"Dobrodzień - miasto (4)";3825;3810;3773;3761;618;594;587;581;2453;2443;2404;2365;1454;1437;1400;1361;999;1006;1004;1004;754;773;782;815;
1608015;"Dobrodzień - obszar wiejski (5)";6240;6241;6257;6242;1059;1056;1057;1027;4103;4108;4102;4095;2555;2518;2468;2448;1548;1590;1634;1647;1078;1077;1098;1120;
1608023;"Gorzów Śląski (3)";7313;7279;7236;7217;1257;1227;1179;1168;4773;4736;4708;4675;2975;2947;2930;2893;1798;1789;1778;1782;1283;1316;1349;1374;
1608024;"Gorzów Śląski - miasto (4)";2544;2532;2508;2491;435;419;401;388;1635;1614;1589;1582;1023;1011;983;969;612;603;606;613;474;499;518;521;
1608025;"Gorzów Śląski - obszar wiejski (5)";4769;4747;4728;4726;822;808;778;780;3138;3122;3119;3093;1952;1936;1947;1924;1186;1186;1172;1169;809;817;831;853;
1608033;"Olesno (3)";18089;18060;18077;17941;2874;2885;2855;2771;11787;11708;11630;11541;7220;7071;6962;6821;4567;4637;4668;4720;3428;3467;3592;3629;
1608034;"Olesno - miasto (4)";9574;9597;9527;9484;1394;1429;1382;1364;6277;6205;6124;6037;3773;3689;3605;3512;2504;2516;2519;2525;1903;1963;2021;2083;
1608035;"Olesno - obszar wiejski (5)";8515;8463;8550;8457;1480;1456;1473;1407;5510;5503;5506;5504;3447;3382;3357;3309;2063;2121;2149;2195;1525;1504;1571;1546;
1608043;"Praszka (3)";13869;13753;13762;13721;2295;2229;2217;2224;9175;8961;8844;8628;5380;5323;5324;5245;3795;3638;3520;3383;2399;2563;2701;2869;
1608044;"Praszka - miasto (4)";8052;7944;7907;7855;1217;1178;1171;1178;5624;5421;5263;5079;3141;3080;3060;2992;2483;2341;2203;2087;1211;1345;1473;1598;
1608045;"Praszka - obszar wiejski (5)";5817;5809;5855;5866;1078;1051;1046;1046;3551;3540;3581;3549;2239;2243;2264;2253;1312;1297;1317;1296;1188;1218;1228;1271;
1608052;"Radłów (2)";4447;4427;4411;4390;828;809;799;776;2872;2872;2873;2868;1807;1787;1753;1734;1065;1085;1120;1134;747;746;739;746;
1608062;"Rudniki (2)";8280;8332;8298;8313;1496;1518;1482;1459;5093;5089;5083;5071;3091;3091;3099;3120;2002;1998;1984;1951;1691;1725;1733;1783;
1608072;"Zębowice (2)";3804;3751;3733;3721;579;566;545;535;2584;2559;2555;2546;1585;1544;1509;1483;999;1015;1046;1063;641;626;633;640;
1609012;"Chrząstowice (2)";6743;6780;6752;6816;1061;1073;1054;1072;4475;4463;4453;4463;2764;2724;2668;2652;1711;1739;1785;1811;1207;1244;1245;1281;
1609022;"Dąbrowa (2)";9579;9597;9590;9632;1648;1615;1600;1602;6358;6370;6349;6365;3842;3848;3818;3798;2516;2522;2531;2567;1573;1612;1641;1665;
1609032;"Dobrzeń Wielki (2)";14437;14517;14580;14552;2373;2346;2357;2352;9776;9807;9790;9710;6203;6145;6048;5877;3573;3662;3742;3833;2288;2364;2433;2490;
1609042;"Komprachcice (2)";11102;11092;11093;11111;1701;1702;1699;1696;7445;7405;7340;7307;4538;4424;4328;4286;2907;2981;3012;3021;1956;1985;2054;2108;
1609052;"Łubniany (2)";9587;9640;9723;9695;1610;1588;1587;1583;6353;6386;6430;6367;3930;3877;3869;3789;2423;2509;2561;2578;1624;1666;1706;1745;
1609062;"Murów (2)";5573;5541;5546;5504;853;827;807;789;3687;3657;3649;3597;2245;2225;2195;2135;1442;1432;1454;1462;1033;1057;1090;1118;
1609073;"Niemodlin (3)";13556;13480;13459;13417;2500;2449;2419;2389;8930;8833;8729;8632;5524;5516;5491;5436;3406;3317;3238;3196;2126;2198;2311;2396;
1609074;"Niemodlin - miasto (4)";6699;6623;6586;6519;1159;1123;1101;1080;4465;4364;4304;4220;2727;2683;2668;2613;1738;1681;1636;1607;1075;1136;1181;1219;
1609075;"Niemodlin - obszar wiejski (5)";6857;6857;6873;6898;1341;1326;1318;1309;4465;4469;4425;4412;2797;2833;2823;2823;1668;1636;1602;1589;1051;1062;1130;1177;
1609083;"Ozimek (3)";20080;19988;19885;19786;2956;2900;2880;2861;13710;13582;13366;13165;8245;8138;7930;7749;5465;5444;5436;5416;3414;3506;3639;3760;
1609084;"Ozimek - miasto (4)";9283;9218;9119;8992;1421;1394;1367;1340;6394;6296;6145;5968;3768;3732;3610;3496;2626;2564;2535;2472;1468;1528;1607;1684;
1609085;"Ozimek - obszar wiejski (5)";10797;10770;10766;10794;1535;1506;1513;1521;7316;7286;7221;7197;4477;4406;4320;4253;2839;2880;2901;2944;1946;1978;2032;2076;
1609092;"Popielów (2)";8208;8156;8126;8086;1318;1296;1280;1253;5382;5332;5273;5220;3282;3247;3214;3184;2100;2085;2059;2036;1508;1528;1573;1613;
1609103;"Prószków (3)";9790;9818;9850;9823;1628;1677;1673;1670;6465;6416;6406;6323;3907;3828;3794;3712;2558;2588;2612;2611;1697;1725;1771;1830;
1609104;"Prószków - miasto (4)";2639;2680;2721;2698;483;548;563;557;1715;1676;1682;1653;1015;978;985;961;700;698;697;692;441;456;476;488;
1609105;"Prószków - obszar wiejski (5)";7151;7138;7129;7125;1145;1129;1110;1113;4750;4740;4724;4670;2892;2850;2809;2751;1858;1890;1915;1919;1256;1269;1295;1342;
1609112;"Tarnów Opolski (2)";9692;9676;9645;9592;1659;1623;1591;1554;6437;6406;6377;6342;3926;3861;3796;3732;2511;2545;2581;2610;1596;1647;1677;1696;
1609122;"Tułowice (2)";5280;5245;5254;5257;957;949;953;934;3521;3450;3417;3375;2122;2093;2091;2099;1399;1357;1326;1276;802;846;884;948;
1609132;"Turawa (2)";9664;9687;9700;9777;1572;1558;1546;1556;6368;6372;6341;6377;3841;3786;3758;3745;2527;2586;2583;2632;1724;1757;1813;1844;
1610013;"Biała (3)";10972;10827;10793;10721;1805;1739;1719;1694;7034;6953;6927;6859;4385;4277;4219;4137;2649;2676;2708;2722;2133;2135;2147;2168;
1610014;"Biała - miasto (4)";2534;2511;2496;2468;417;406;392;376;1605;1591;1573;1554;1002;985;977;946;603;606;596;608;512;514;531;538;
1610015;"Biała - obszar wiejski (5)";8438;8316;8297;8253;1388;1333;1327;1318;5429;5362;5354;5305;3383;3292;3242;3191;2046;2070;2112;2114;1621;1621;1616;1630;
1610023;"Głogówek (3)";13715;13682;13620;13445;2367;2343;2319;2225;8809;8802;8745;8664;5367;5322;5232;5178;3442;3480;3513;3486;2539;2537;2556;2556;
1610024;"Głogówek - miasto (4)";5756;5770;5702;5608;1031;1016;1004;962;3692;3717;3673;3628;2308;2324;2269;2241;1384;1393;1404;1387;1033;1037;1025;1018;
1610025;"Głogówek - obszar wiejski (5)";7959;7912;7918;7837;1336;1327;1315;1263;5117;5085;5072;5036;3059;2998;2963;2937;2058;2087;2109;2099;1506;1500;1531;1538;
1610032;"Lubrza (2)";4386;4363;4360;4363;785;771;766;751;2855;2832;2803;2797;1769;1762;1763;1769;1086;1070;1040;1028;746;760;791;815;
1610043;"Prudnik (3)";28183;27956;27835;27645;4775;4677;4615;4512;17772;17533;17335;17104;10804;10712;10671;10577;6968;6821;6664;6527;5636;5746;5885;6029;
1610044;"Prudnik - miasto (4)";21979;21778;21676;21472;3565;3501;3471;3391;13764;13534;13364;13122;8303;8209;8152;8045;5461;5325;5212;5077;4650;4743;4841;4959;
1610045;"Prudnik - obszar wiejski (5)";6204;6178;6159;6173;1210;1176;1144;1121;4008;3999;3971;3982;2501;2503;2519;2532;1507;1496;1452;1450;986;1003;1044;1070;
1611012;"Izbicko (2)";5418;5424;5408;5413;919;908;895;914;3574;3573;3550;3519;2191;2198;2179;2147;1383;1375;1371;1372;925;943;963;980;
1611022;"Jemielnica (2)";7224;7147;7167;7176;1186;1151;1170;1178;4865;4819;4792;4794;3016;2947;2920;2885;1849;1872;1872;1909;1173;1177;1205;1204;
1611033;"Kolonowskie (3)";6038;5962;5969;5957;842;837;852;880;4028;3958;3939;3872;2424;2359;2329;2295;1604;1599;1610;1577;1168;1167;1178;1205;
1611034;"Kolonowskie - miasto (4)";3396;3361;3361;3343;511;505;512;517;2272;2244;2229;2182;1373;1338;1312;1283;899;906;917;899;613;612;620;644;
1611035;"Kolonowskie - obszar wiejski (5)";2642;2601;2608;2614;331;332;340;363;1756;1714;1710;1690;1051;1021;1017;1012;705;693;693;678;555;555;558;561;
1611043;"Leśnica (3)";8056;8018;7966;7849;1333;1334;1307;1286;5301;5261;5189;5082;3224;3162;3078;2974;2077;2099;2111;2108;1422;1423;1470;1481;
1611044;"Leśnica - miasto (4)";2696;2717;2690;2664;502;518;526;512;1726;1713;1659;1629;1071;1048;993;969;655;665;666;660;468;486;505;523;
1611045;"Leśnica - obszar wiejski (5)";5360;5301;5276;5185;831;816;781;774;3575;3548;3530;3453;2153;2114;2085;2005;1422;1434;1445;1448;954;937;965;958;
1611053;"Strzelce Opolskie (3)";31516;31304;31194;31040;5187;5128;5036;4978;20679;20348;20149;19925;12700;12489;12365;12199;7979;7859;7784;7726;5650;5828;6009;6137;
1611054;"Strzelce Opolskie - miasto (4)";18610;18451;18373;18244;3036;2994;2941;2901;12164;11899;11730;11519;7419;7286;7204;7088;4745;4613;4526;4431;3410;3558;3702;3824;
1611055;"Strzelce Opolskie - obszar wiejski (5)";12906;12853;12821;12796;2151;2134;2095;2077;8515;8449;8419;8406;5281;5203;5161;5111;3234;3246;3258;3295;2240;2270;2307;2313;
1611063;"Ujazd (3)";6282;6346;6340;6351;1188;1189;1174;1176;4075;4127;4136;4127;2659;2660;2637;2635;1416;1467;1499;1492;1019;1030;1030;1048;
1611064;"Ujazd - miasto (4)";1719;1740;1723;1747;338;339;333;353;1117;1132;1120;1117;712;715;695;700;405;417;425;417;264;269;270;277;
1611065;"Ujazd - obszar wiejski (5)";4563;4606;4617;4604;850;850;841;823;2958;2995;3016;3010;1947;1945;1942;1935;1011;1050;1074;1075;755;761;760;771;
1611073;"Zawadzkie (3)";12014;11878;11759;11654;1695;1670;1602;1583;8056;7930;7846;7728;4963;4827;4720;4582;3093;3103;3126;3146;2263;2278;2311;2343;
1611074;"Zawadzkie - miasto (4)";7703;7605;7493;7411;1068;1040;977;955;5184;5076;5008;4930;3156;3045;2981;2896;2028;2031;2027;2034;1451;1489;1508;1526;
1611075;"Zawadzkie - obszar wiejski (5)";4311;4273;4266;4243;627;630;625;628;2872;2854;2838;2798;1807;1782;1739;1686;1065;1072;1099;1112;812;789;803;817;
1661011;"Opole (1)";121576;120146;119574;118931;17875;17750;17692;17862;79106;76946;75492;73773;49123;47766;46991;45948;29983;29180;28501;27825;24595;25450;26390;27296;
1801032;"Czarna (2)";2414;2391;2413;2402;487;465;462;453;1606;1603;1618;1605;1007;996;1012;1008;599;607;606;597;321;323;333;344;
1801052;"Lutowiska (2)";2120;2115;2092;2089;385;354;335;332;1440;1452;1435;1422;916;934;916;902;524;518;519;520;295;309;322;335;
1801083;"Ustrzyki Dolne (3)";17733;17698;17650;17581;3379;3252;3178;3099;11620;11610;11530;11431;7215;7194;7144;7106;4405;4416;4386;4325;2734;2836;2942;3051;
1801084;"Ustrzyki Dolne - miasto (4)";9521;9445;9383;9335;1685;1638;1590;1570;6452;6339;6237;6131;3905;3852;3805;3763;2547;2487;2432;2368;1384;1468;1556;1634;
1801085;"Ustrzyki Dolne - obszar wiejski (5)";8212;8253;8267;8246;1694;1614;1588;1529;5168;5271;5293;5300;3310;3342;3339;3343;1858;1929;1954;1957;1350;1368;1386;1417;
1802013;"Brzozów (3)";26738;26604;26625;26611;5628;5471;5389;5325;16935;16859;16806;16691;10926;10856;10880;10831;6009;6003;5926;5860;4175;4274;4430;4595;
1802014;"Brzozów - miasto (4)";7631;7550;7548;7509;1362;1333;1298;1290;4897;4790;4750;4649;3017;2960;2973;2929;1880;1830;1777;1720;1372;1427;1500;1570;
1802015;"Brzozów - obszar wiejski (5)";19107;19054;19077;19102;4266;4138;4091;4035;12038;12069;12056;12042;7909;7896;7907;7902;4129;4173;4149;4140;2803;2847;2930;3025;
1802022;"Domaradz (2)";6141;6139;6091;6069;1298;1265;1239;1201;3793;3822;3793;3820;2470;2486;2450;2449;1323;1336;1343;1371;1050;1052;1059;1048;
1802032;"Dydnia (2)";8185;8135;8116;8054;1681;1655;1619;1548;5143;5098;5099;5094;3378;3328;3292;3272;1765;1770;1807;1822;1361;1382;1398;1412;
1802042;"Haczów (2)";9288;9336;9294;9303;1956;1930;1892;1877;5789;5825;5777;5761;3733;3775;3740;3709;2056;2050;2037;2052;1543;1581;1625;1665;
1802052;"Jasienica Rosielna (2)";7734;7722;7732;7769;1816;1763;1724;1690;4817;4855;4855;4902;3221;3215;3200;3230;1596;1640;1655;1672;1101;1104;1153;1177;
1802062;"Nozdrzec (2)";8460;8398;8362;8306;1638;1596;1577;1554;5134;5105;5068;5029;3393;3350;3297;3257;1741;1755;1771;1772;1688;1697;1717;1723;
1803011;"Dębica (1)";47180;46854;46568;46389;8349;8205;8106;8051;31211;30703;30149;29699;19231;18945;18630;18384;11980;11758;11519;11315;7620;7946;8313;8639;
1803023;"Brzostek (3)";13185;13187;13204;13167;2939;2847;2788;2743;8182;8242;8265;8240;5388;5410;5414;5377;2794;2832;2851;2863;2064;2098;2151;2184;
1803024;"Brzostek - miasto (4)";2697;2718;2716;2712;560;538;527;511;1783;1810;1807;1796;1144;1165;1155;1147;639;645;652;649;354;370;382;405;
1803025;"Brzostek - obszar wiejski (5)";10488;10469;10488;10455;2379;2309;2261;2232;6399;6432;6458;6444;4244;4245;4259;4230;2155;2187;2199;2214;1710;1728;1769;1779;
1803032;"Czarna (2)";12808;12849;12862;12958;2665;2614;2582;2582;8196;8266;8294;8349;5409;5435;5446;5474;2787;2831;2848;2875;1947;1969;1986;2027;
1803042;"Dębica (2)";25097;25197;25368;25490;5481;5410;5368;5324;15855;15928;16071;16132;10601;10639;10685;10653;5254;5289;5386;5479;3761;3859;3929;4034;
1803052;"Jodłowa (2)";5442;5425;5406;5416;1117;1085;1075;1069;3417;3423;3404;3401;2208;2204;2174;2159;1209;1219;1230;1242;908;917;927;946;
1803063;"Pilzno (3)";17885;17969;17958;18026;3916;3867;3754;3702;11102;11176;11216;11282;7454;7505;7471;7492;3648;3671;3745;3790;2867;2926;2988;3042;
1803064;"Pilzno - miasto (4)";4762;4792;4802;4815;996;981;961;968;3039;3061;3060;3043;2018;2048;2032;2014;1021;1013;1028;1029;727;750;781;804;
1803065;"Pilzno - obszar wiejski (5)";13123;13177;13156;13211;2920;2886;2793;2734;8063;8115;8156;8239;5436;5457;5439;5478;2627;2658;2717;2761;2140;2176;2207;2238;
1803072;"Żyraków (2)";13642;13684;13749;13847;2972;2910;2864;2830;8634;8694;8779;8880;5751;5765;5777;5824;2883;2929;3002;3056;2036;2080;2106;2137;
1804011;"Jarosław (1)";39426;39138;38796;38360;6680;6644;6442;6269;25376;24821;24398;23844;15929;15623;15412;15044;9447;9198;8986;8800;7370;7673;7956;8247;
1804021;"Radymno (1)";5528;5501;5433;5366;1003;941;907;870;3746;3732;3667;3605;2326;2311;2244;2194;1420;1421;1423;1411;779;828;859;891;
1804032;"Chłopice (2)";5625;5609;5610;5615;1101;1049;1039;1024;3581;3613;3600;3591;2345;2367;2361;2351;1236;1246;1239;1240;943;947;971;1000;
1804042;"Jarosław (2)";13082;13061;13137;13169;2768;2717;2664;2633;8377;8365;8403;8404;5474;5456;5479;5481;2903;2909;2924;2923;1937;1979;2070;2132;
1804052;"Laszki (2)";6989;7037;7035;7022;1500;1482;1477;1448;4401;4420;4414;4396;2847;2892;2903;2879;1554;1528;1511;1517;1088;1135;1144;1178;
1804062;"Pawłosiów (2)";8354;8345;8385;8433;1687;1632;1581;1563;5357;5376;5418;5439;3410;3408;3445;3463;1947;1968;1973;1976;1310;1337;1386;1431;
1804073;"Pruchnik (3)";9841;9845;9825;9834;2187;2114;2090;2062;6126;6173;6149;6177;4059;4058;4022;4035;2067;2115;2127;2142;1528;1558;1586;1595;
1804074;"Pruchnik - miasto (4)";3716;3751;3747;3772;776;755;751;757;2372;2410;2400;2418;1539;1552;1533;1541;833;858;867;877;568;586;596;597;
1804075;"Pruchnik - obszar wiejski (5)";6125;6094;6078;6062;1411;1359;1339;1305;3754;3763;3749;3759;2520;2506;2489;2494;1234;1257;1260;1265;960;972;990;998;
1804082;"Radymno (2)";11476;11431;11435;11454;2453;2389;2373;2298;7158;7144;7120;7195;4713;4699;4657;4713;2445;2445;2463;2482;1865;1898;1942;1961;
1804092;"Rokietnica (2)";4390;4396;4374;4375;933;902;888;881;2685;2711;2713;2719;1762;1784;1772;1777;923;927;941;942;772;783;773;775;
1804102;"Roźwienica (2)";6237;6215;6185;6218;1299;1262;1228;1229;3939;3951;3954;3980;2596;2606;2588;2597;1343;1345;1366;1383;999;1002;1003;1009;
1804112;"Wiązownica (2)";11466;11552;11580;11662;2513;2498;2433;2412;7344;7397;7442;7491;4809;4838;4875;4876;2535;2559;2567;2615;1609;1657;1705;1759;
1805011;"Jasło (1)";36641;36363;36260;36001;6179;5982;5825;5683;23756;23392;23198;22829;14340;14114;14025;13858;9416;9278;9173;8971;6706;6989;7237;7489;
1805022;"Brzyska (2)";6455;6464;6487;6498;1394;1362;1340;1319;4079;4092;4118;4149;2743;2770;2779;2762;1336;1322;1339;1387;982;1010;1029;1030;
1805032;"Dębowiec (2)";8646;8675;8701;8731;1790;1769;1748;1727;5437;5451;5468;5496;3514;3511;3483;3500;1923;1940;1985;1996;1419;1455;1485;1508;
1805042;"Jasło (2)";16340;16417;16406;16395;3245;3229;3098;3044;10374;10445;10511;10462;6609;6600;6633;6568;3765;3845;3878;3894;2721;2743;2797;2889;
1805053;"Kołaczyce (3)";9062;9060;9028;8957;1927;1875;1837;1759;5748;5771;5757;5741;3810;3798;3751;3720;1938;1973;2006;2021;1387;1414;1434;1457;
1805054;"Kołaczyce - miasto (4)";1447;1447;1437;1416;255;255;263;251;948;940;912;887;607;594;561;554;341;346;351;333;244;252;262;278;
1805055;"Kołaczyce - obszar wiejski (5)";7615;7613;7591;7541;1672;1620;1574;1508;4800;4831;4845;4854;3203;3204;3190;3166;1597;1627;1655;1688;1143;1162;1172;1179;
1805062;"Krempna (2)";2001;1989;1934;1917;392;367;344;321;1349;1351;1316;1311;846;843;811;815;503;508;505;496;260;271;274;285;
1805072;"Nowy Żmigród (2)";9346;9320;9263;9218;1817;1786;1721;1686;5942;5937;5922;5875;3832;3812;3799;3769;2110;2125;2123;2106;1587;1597;1620;1657;
1805082;"Osiek Jasielski (2)";5411;5389;5392;5403;1121;1081;1056;1049;3452;3460;3469;3474;2261;2251;2273;2271;1191;1209;1196;1203;838;848;867;880;
1805092;"Skołyszyn (2)";12538;12512;12500;12449;2513;2442;2412;2343;7966;7951;7921;7902;5205;5177;5128;5093;2761;2774;2793;2809;2059;2119;2167;2204;
1805112;"Tarnowiec (2)";9221;9199;9214;9204;1830;1772;1725;1699;5778;5799;5832;5823;3694;3680;3691;3662;2084;2119;2141;2161;1613;1628;1657;1682;
1806012;"Cmolas (2)";8109;8116;8115;8122;1789;1713;1667;1638;5011;5084;5112;5145;3404;3418;3417;3401;1607;1666;1695;1744;1309;1319;1336;1339;
1806023;"Kolbuszowa (3)";25020;24997;24941;24891;4830;4693;4592;4447;16224;16217;16113;16105;10696;10666;10527;10505;5528;5551;5586;5600;3966;4087;4236;4339;
1806024;"Kolbuszowa - miasto (4)";9341;9329;9270;9236;1685;1633;1600;1545;6239;6187;6070;6018;3967;3958;3871;3856;2272;2229;2199;2162;1417;1509;1600;1673;
1806025;"Kolbuszowa - obszar wiejski (5)";15679;15668;15671;15655;3145;3060;2992;2902;9985;10030;10043;10087;6729;6708;6656;6649;3256;3322;3387;3438;2549;2578;2636;2666;
1806032;"Majdan Królewski (2)";9917;9916;9899;9878;2086;2037;1971;1920;6310;6343;6367;6348;4198;4197;4195;4151;2112;2146;2172;2197;1521;1536;1561;1610;
1806042;"Niwiska (2)";6022;6036;6030;6032;1349;1308;1286;1249;3714;3756;3748;3767;2520;2538;2529;2545;1194;1218;1219;1222;959;972;996;1016;
1806052;"Raniżów (2)";7166;7177;7159;7098;1497;1462;1434;1422;4537;4575;4569;4531;2986;3001;2987;2931;1551;1574;1582;1600;1132;1140;1156;1145;
1806062;"Dzikowiec (2)";6522;6509;6512;6492;1367;1324;1290;1231;4148;4172;4199;4207;2772;2777;2780;2778;1376;1395;1419;1429;1007;1013;1023;1054;
1807012;"Chorkówka (2)";13499;13455;13483;13448;2911;2853;2806;2722;8379;8368;8389;8383;5456;5429;5468;5460;2923;2939;2921;2923;2209;2234;2288;2343;
1807023;"Dukla (3)";14816;14825;14739;14744;2992;2919;2842;2805;9285;9293;9260;9254;5888;5921;5893;5859;3397;3372;3367;3395;2539;2613;2637;2685;
1807024;"Dukla - miasto (4)";2194;2160;2122;2127;391;377;363;369;1466;1430;1394;1388;901;887;865;863;565;543;529;525;337;353;365;370;
1807025;"Dukla - obszar wiejski (5)";12622;12665;12617;12617;2601;2542;2479;2436;7819;7863;7866;7866;4987;5034;5028;4996;2832;2829;2838;2870;2202;2260;2272;2315;
1807033;"Iwonicz-Zdrój (3)";10917;10982;10978;10985;2312;2339;2306;2233;6850;6834;6827;6875;4332;4316;4303;4346;2518;2518;2524;2529;1755;1809;1845;1877;
1807034;"Iwonicz-Zdrój - miasto (4)";1904;1852;1839;1849;314;299;294;297;1154;1118;1108;1107;659;634;629;627;495;484;479;480;436;435;437;445;
1807035;"Iwonicz-Zdrój - obszar wiejski (5)";9013;9130;9139;9136;1998;2040;2012;1936;5696;5716;5719;5768;3673;3682;3674;3719;2023;2034;2045;2049;1319;1374;1408;1432;
1807043;"Jedlicze (3)";15529;15476;15498;15511;2956;2881;2879;2865;9900;9825;9777;9747;6260;6233;6184;6142;3640;3592;3593;3605;2673;2770;2842;2899;
1807044;"Jedlicze - miasto (4)";5782;5748;5775;5754;1009;982;1005;988;3740;3690;3662;3637;2302;2285;2266;2226;1438;1405;1396;1411;1033;1076;1108;1129;
1807045;"Jedlicze - obszar wiejski (5)";9747;9728;9723;9757;1947;1899;1874;1877;6160;6135;6115;6110;3958;3948;3918;3916;2202;2187;2197;2194;1640;1694;1734;1770;
1807052;"Korczyna (2)";11036;11031;11101;11109;2220;2178;2202;2164;6906;6934;6944;6921;4492;4499;4487;4460;2414;2435;2457;2461;1910;1919;1955;2024;
1807062;"Krościenko Wyżne (2)";5507;5532;5544;5570;1233;1211;1178;1167;3438;3462;3451;3469;2231;2244;2220;2209;1207;1218;1231;1260;836;859;915;934;
1807072;"Miejsce Piastowe (2)";13568;13550;13662;13640;2747;2691;2654;2583;8514;8480;8550;8525;5511;5465;5464;5461;3003;3015;3086;3064;2307;2379;2458;2532;
1807083;"Rymanów (3)";15737;15763;15756;15809;3123;3120;3103;3097;9906;9843;9786;9772;6170;6134;6094;6095;3736;3709;3692;3677;2708;2800;2867;2940;
1807084;"Rymanów - miasto (4)";3753;3696;3715;3776;699;690;699;706;2390;2323;2307;2341;1410;1360;1347;1390;980;963;960;951;664;683;709;729;
1807085;"Rymanów - obszar wiejski (5)";11984;12067;12041;12033;2424;2430;2404;2391;7516;7520;7479;7431;4760;4774;4747;4705;2756;2746;2732;2726;2044;2117;2158;2211;
1807092;"Wojaszówka (2)";9171;9202;9252;9247;1807;1805;1808;1781;5784;5773;5777;5777;3687;3666;3647;3647;2097;2107;2130;2130;1580;1624;1667;1689;
1807102;"Jaśliska (2)";2078;2067;2051;2054;457;445;434;424;1261;1256;1241;1246;831;814;801;799;430;442;440;447;360;366;376;384;
1808011;"Leżajsk (1)";14448;14363;14252;14122;2507;2461;2395;2273;9489;9268;9048;8916;5879;5764;5671;5586;3610;3504;3377;3330;2452;2634;2809;2933;
1808022;"Grodzisko Dolne (2)";8113;8094;8068;8081;1651;1607;1566;1541;4984;5007;5015;5041;3293;3303;3277;3264;1691;1704;1738;1777;1478;1480;1487;1499;
1808032;"Kuryłówka (2)";5744;5725;5701;5699;1162;1127;1088;1093;3655;3665;3656;3645;2340;2327;2312;2300;1315;1338;1344;1345;927;933;957;961;
1808042;"Leżajsk (2)";20061;20065;20107;20145;4277;4191;4129;4053;12711;12739;12797;12852;8347;8360;8369;8375;4364;4379;4428;4477;3073;3135;3181;3240;
1808053;"Nowa Sarzyna (3)";21740;21730;21728;21654;4615;4518;4388;4260;13756;13751;13762;13735;8932;8931;8942;8893;4824;4820;4820;4842;3369;3461;3578;3659;
1808054;"Nowa Sarzyna - miasto (4)";6287;6177;6102;6050;1114;1072;1042;1008;4230;4102;3986;3884;2580;2519;2456;2444;1650;1583;1530;1440;943;1003;1074;1158;
1808055;"Nowa Sarzyna - obszar wiejski (5)";15453;15553;15626;15604;3501;3446;3346;3252;9526;9649;9776;9851;6352;6412;6486;6449;3174;3237;3290;3402;2426;2458;2504;2501;
1809011;"Lubaczów (1)";12552;12517;12416;12304;2278;2258;2204;2116;8405;8282;8120;7957;5155;5100;5034;4962;3250;3182;3086;2995;1869;1977;2092;2231;
1809023;"Cieszanów (3)";7548;7516;7478;7413;1469;1425;1368;1338;4822;4810;4784;4729;3122;3097;3080;3040;1700;1713;1704;1689;1257;1281;1326;1346;
1809024;"Cieszanów - miasto (4)";1962;1975;1985;1969;363;357;339;330;1310;1315;1321;1306;820;820;830;827;490;495;491;479;289;303;325;333;
1809025;"Cieszanów - obszar wiejski (5)";5586;5541;5493;5444;1106;1068;1029;1008;3512;3495;3463;3423;2302;2277;2250;2213;1210;1218;1213;1210;968;978;1001;1013;
1809032;"Horyniec-Zdrój (2)";4972;4931;4915;4845;934;877;840;808;3138;3141;3126;3074;2011;2025;2006;1963;1127;1116;1120;1111;900;913;949;963;
1809042;"Lubaczów (2)";9122;9118;9139;9156;1888;1813;1797;1767;5769;5839;5887;5929;3812;3847;3864;3882;1957;1992;2023;2047;1465;1466;1455;1460;
1809053;"Narol (3)";8297;8301;8232;8209;1517;1459;1431;1402;5141;5197;5162;5137;3176;3229;3180;3159;1965;1968;1982;1978;1639;1645;1639;1670;
1809054;"Narol - miasto (4)";2100;2110;2107;2112;407;401;402;405;1399;1399;1388;1375;853;854;851;838;546;545;537;537;294;310;317;332;
1809055;"Narol - obszar wiejski (5)";6197;6191;6125;6097;1110;1058;1029;997;3742;3798;3774;3762;2323;2375;2329;2321;1419;1423;1445;1441;1345;1335;1322;1338;
1809063;"Oleszyce (3)";6530;6418;6494;6418;1321;1242;1221;1158;4181;4123;4179;4143;2670;2623;2687;2663;1511;1500;1492;1480;1028;1053;1094;1117;
1809064;"Oleszyce - miasto (4)";3108;3053;3093;3037;581;568;546;506;2067;2003;2040;2022;1303;1249;1290;1268;764;754;750;754;460;482;507;509;
1809065;"Oleszyce - obszar wiejski (5)";3422;3365;3401;3381;740;674;675;652;2114;2120;2139;2121;1367;1374;1397;1395;747;746;742;726;568;571;587;608;
1809072;"Stary Dzików (2)";4350;4352;4335;4334;848;793;786;788;2677;2714;2687;2686;1683;1717;1702;1705;994;997;985;981;825;845;862;860;
1809082;"Wielkie Oczy (2)";3912;3904;3886;3857;792;763;757;734;2439;2460;2454;2446;1627;1639;1618;1606;812;821;836;840;681;681;675;677;
1810011;"Łańcut (1)";18143;18074;17982;17830;3303;3286;3216;3131;11352;11213;11072;10898;7123;7026;6967;6857;4229;4187;4105;4041;3488;3575;3694;3801;
1810022;"Białobrzegi (2)";8404;8438;8512;8589;1853;1824;1820;1830;5204;5243;5276;5294;3470;3500;3539;3539;1734;1743;1737;1755;1347;1371;1416;1465;
1810032;"Czarna (2)";11215;11335;11426;11534;2370;2342;2337;2329;7082;7191;7278;7341;4720;4789;4831;4833;2362;2402;2447;2508;1763;1802;1811;1864;
1810042;"Łańcut (2)";21161;21265;21395;21482;4460;4431;4403;4372;13061;13118;13167;13190;8596;8616;8646;8668;4465;4502;4521;4522;3640;3716;3825;3920;
1810052;"Markowa (2)";6601;6595;6563;6535;1348;1315;1284;1263;4065;4081;4062;4050;2642;2629;2599;2576;1423;1452;1463;1474;1188;1199;1217;1222;
1810062;"Rakszawa (2)";7264;7261;7237;7264;1582;1554;1517;1507;4517;4528;4513;4508;2970;2978;2964;2972;1547;1550;1549;1536;1165;1179;1207;1249;
1810072;"Żołynia (2)";6872;6898;6913;6967;1487;1487;1480;1483;4227;4260;4252;4263;2826;2844;2833;2859;1401;1416;1419;1404;1158;1151;1181;1221;
1811011;"Mielec (1)";61238;61096;60827;60644;10294;10193;10094;10091;40129;39574;38969;38312;24565;24375;24107;23820;15564;15199;14862;14492;10815;11329;11764;12241;
1811022;"Borowa (2)";5635;5646;5636;5612;1189;1154;1123;1086;3509;3542;3556;3550;2373;2394;2393;2372;1136;1148;1163;1178;937;950;957;976;
1811032;"Czermin (2)";6952;6984;7002;7032;1529;1507;1464;1450;4357;4407;4455;4483;2954;2976;3014;3020;1403;1431;1441;1463;1066;1070;1083;1099;
1811042;"Gawłuszowice (2)";2795;2772;2765;2748;559;535;527;505;1743;1730;1730;1731;1158;1141;1138;1132;585;589;592;599;493;507;508;512;
1811052;"Mielec (2)";12941;13007;13083;13179;2682;2637;2612;2602;8207;8262;8297;8377;5389;5404;5414;5412;2818;2858;2883;2965;2052;2108;2174;2200;
1811062;"Padew Narodowa (2)";5441;5449;5394;5386;1073;1057;1039;1023;3399;3416;3372;3350;2216;2224;2186;2165;1183;1192;1186;1185;969;976;983;1013;
1811073;"Przecław (3)";11585;11669;11756;11792;2607;2598;2575;2552;7271;7325;7405;7432;4828;4865;4918;4927;2443;2460;2487;2505;1707;1746;1776;1808;
1811074;"Przecław - miasto (4)";1682;1711;1723;1738;410;414;409;402;1071;1081;1090;1115;740;749;754;775;331;332;336;340;201;216;224;221;
1811075;"Przecław - obszar wiejski (5)";9903;9958;10033;10054;2197;2184;2166;2150;6200;6244;6315;6317;4088;4116;4164;4152;2112;2128;2151;2165;1506;1530;1552;1587;
1811083;"Radomyśl Wielki (3)";14187;14164;14179;14179;3253;3193;3098;3036;8799;8789;8839;8885;5990;5953;5996;5986;2809;2836;2843;2899;2135;2182;2242;2258;
1811084;"Radomyśl Wielki - miasto (4)";3079;3080;3104;3149;701;675;669;671;2025;2045;2055;2080;1363;1353;1369;1378;662;692;686;702;353;360;380;398;
1811085;"Radomyśl Wielki - obszar wiejski (5)";11108;11084;11075;11030;2552;2518;2429;2365;6774;6744;6784;6805;4627;4600;4627;4608;2147;2144;2157;2197;1782;1822;1862;1860;
1811092;"Tuszów Narodowy (2)";7934;8014;8063;8081;1699;1701;1686;1674;4953;5035;5074;5074;3378;3410;3435;3426;1575;1625;1639;1648;1282;1278;1303;1333;
1811102;"Wadowice Górne (2)";7588;7602;7608;7610;1749;1731;1679;1629;4633;4638;4699;4765;3193;3170;3200;3205;1440;1468;1499;1560;1206;1233;1230;1216;
1812012;"Harasiuki (2)";6283;6236;6207;6186;1201;1110;1044;1004;3986;4038;4071;4069;2542;2575;2588;2571;1444;1463;1483;1498;1096;1088;1092;1113;
1812022;"Jarocin (2)";5417;5444;5463;5430;1021;988;978;945;3514;3554;3561;3562;2275;2301;2302;2290;1239;1253;1259;1272;882;902;924;923;
1812032;"Jeżowe (2)";10163;10148;10155;10186;2335;2262;2227;2157;6426;6461;6469;6545;4393;4383;4336;4344;2033;2078;2133;2201;1402;1425;1459;1484;
1812042;"Krzeszów (2)";4313;4289;4272;4261;798;758;723;705;2724;2727;2751;2742;1721;1736;1744;1746;1003;991;1007;996;791;804;798;814;
1812053;"Nisko (3)";22477;22493;22450;22422;4097;3999;3876;3777;15162;15145;15096;15040;9331;9286;9233;9202;5831;5859;5863;5838;3218;3349;3478;3605;
1812054;"Nisko - miasto (4)";15479;15484;15453;15423;2724;2674;2598;2521;10653;10608;10562;10520;6406;6362;6340;6331;4247;4246;4222;4189;2102;2202;2293;2382;
1812055;"Nisko - obszar wiejski (5)";6998;7009;6997;6999;1373;1325;1278;1256;4509;4537;4534;4520;2925;2924;2893;2871;1584;1613;1641;1649;1116;1147;1185;1223;
1812063;"Rudnik nad Sanem (3)";10343;10320;10275;10242;1888;1818;1780;1734;6675;6687;6665;6636;4186;4215;4200;4154;2489;2472;2465;2482;1780;1815;1830;1872;
1812064;"Rudnik nad Sanem - miasto (4)";6883;6858;6811;6784;1238;1188;1155;1141;4439;4433;4413;4377;2765;2788;2770;2720;1674;1645;1643;1657;1206;1237;1243;1266;
1812065;"Rudnik nad Sanem - obszar wiejski (5)";3460;3462;3464;3458;650;630;625;593;2236;2254;2252;2259;1421;1427;1430;1434;815;827;822;825;574;578;587;606;
1812073;"Ulanów (3)";8660;8591;8531;8451;1616;1531;1472;1393;5556;5536;5490;5450;3607;3594;3562;3546;1949;1942;1928;1904;1488;1524;1569;1608;
1812074;"Ulanów - miasto (4)";1482;1472;1447;1430;265;252;230;223;956;940;914;896;579;577;571;557;377;363;343;339;261;280;303;311;
1812075;"Ulanów - obszar wiejski (5)";7178;7119;7084;7021;1351;1279;1242;1170;4600;4596;4576;4554;3028;3017;2991;2989;1572;1579;1585;1565;1227;1244;1266;1297;
1813012;"Bircza (2)";6703;6746;6708;6715;1364;1323;1292;1260;4252;4314;4296;4334;2762;2801;2763;2776;1490;1513;1533;1558;1087;1109;1120;1121;
1813022;"Dubiecko (2)";9521;9432;9378;9348;2002;1926;1880;1829;5724;5706;5678;5679;3771;3741;3708;3685;1953;1965;1970;1994;1795;1800;1820;1840;
1813032;"Fredropol (2)";5537;5554;5537;5546;1177;1137;1111;1072;3498;3543;3544;3584;2258;2308;2292;2317;1240;1235;1252;1267;862;874;882;890;
1813042;"Krasiczyn (2)";5052;5122;5129;5146;1088;1074;1050;1018;3258;3312;3334;3340;2106;2128;2142;2158;1152;1184;1192;1182;706;736;745;788;
1813052;"Krzywcza (2)";4950;4897;4890;4882;1019;983;955;930;3180;3154;3140;3135;2103;2091;2082;2084;1077;1063;1058;1051;751;760;795;817;
1813062;"Medyka (2)";6443;6459;6498;6539;1371;1333;1305;1297;4192;4217;4256;4259;2763;2796;2815;2829;1429;1421;1441;1430;880;909;937;983;
1813072;"Orły (2)";8760;8846;8859;8860;1898;1896;1871;1830;5661;5730;5710;5694;3715;3752;3733;3734;1946;1978;1977;1960;1201;1220;1278;1336;
1813082;"Przemyśl (2)";10109;10176;10172;10417;1962;1930;1837;1828;6681;6747;6804;6996;4302;4297;4325;4435;2379;2450;2479;2561;1466;1499;1531;1593;
1813092;"Stubno (2)";4065;4020;3966;3942;891;856;796;764;2547;2537;2532;2514;1658;1645;1637;1633;889;892;895;881;627;627;638;664;
1813102;"Żurawica (2)";12913;12973;12930;12920;2596;2549;2466;2410;8328;8381;8382;8343;5389;5394;5368;5323;2939;2987;3014;3020;1989;2043;2082;2167;
1814011;"Przeworsk (1)";15915;15779;15681;15585;2894;2801;2766;2730;10290;10109;9914;9723;6456;6360;6261;6154;3834;3749;3653;3569;2731;2869;3001;3132;
1814022;"Adamówka (2)";4192;4174;4136;4112;913;878;849;814;2570;2586;2579;2581;1688;1694;1678;1665;882;892;901;916;709;710;708;717;
1814032;"Gać (2)";4677;4672;4654;4609;994;963;943;917;2853;2871;2859;2838;1850;1864;1863;1822;1003;1007;996;1016;830;838;852;854;
1814042;"Jawornik Polski (2)";4603;4612;4555;4509;810;797;778;736;2837;2873;2831;2822;1856;1859;1827;1820;981;1014;1004;1002;956;942;946;951;
1814053;"Kańczuga (3)";12596;12586;12551;12490;2472;2436;2386;2334;7845;7861;7865;7811;5094;5107;5101;5036;2751;2754;2764;2775;2279;2289;2300;2345;
1814054;"Kańczuga - miasto (4)";3242;3236;3237;3240;549;544;541;559;2284;2273;2263;2220;1455;1457;1443;1396;829;816;820;824;409;419;433;461;
1814055;"Kańczuga - obszar wiejski (5)";9354;9350;9314;9250;1923;1892;1845;1775;5561;5588;5602;5591;3639;3650;3658;3640;1922;1938;1944;1951;1870;1870;1867;1884;
1814062;"Przeworsk (2)";14814;14876;14875;14935;3098;3055;3020;3011;9198;9248;9241;9295;6021;6077;6043;6065;3177;3171;3198;3230;2518;2573;2614;2629;
1814073;"Sieniawa (3)";7043;7026;7028;7031;1492;1442;1390;1356;4556;4577;4604;4616;2870;2870;2883;2898;1686;1707;1721;1718;995;1007;1034;1059;
1814074;"Sieniawa - miasto (4)";2198;2179;2157;2153;425;390;373;357;1521;1527;1506;1504;910;903;884;885;611;624;622;619;252;262;278;292;
1814075;"Sieniawa - obszar wiejski (5)";4845;4847;4871;4878;1067;1052;1017;999;3035;3050;3098;3112;1960;1967;1999;2013;1075;1083;1099;1099;743;745;756;767;
1814082;"Tryńcza (2)";8307;8337;8362;8422;1826;1782;1761;1730;5147;5209;5246;5304;3487;3506;3517;3559;1660;1703;1729;1745;1334;1346;1355;1388;
1814092;"Zarzecze (2)";7157;7200;7185;7176;1502;1494;1437;1394;4509;4519;4548;4567;2929;2973;3001;3005;1580;1546;1547;1562;1146;1187;1200;1215;
1815012;"Iwierzyce (2)";7602;7628;7649;7668;1629;1585;1560;1547;4756;4792;4810;4809;3206;3241;3227;3193;1550;1551;1583;1616;1217;1251;1279;1312;
1815022;"Ostrów (2)";7135;7169;7160;7189;1540;1505;1460;1441;4517;4589;4602;4621;3057;3104;3111;3129;1460;1485;1491;1492;1078;1075;1098;1127;
1815033;"Ropczyce (3)";26853;26973;27038;27089;5635;5609;5572;5519;17357;17362;17315;17240;11377;11349;11325;11260;5980;6013;5990;5980;3861;4002;4151;4330;
1815034;"Ropczyce - miasto (4)";15655;15683;15722;15717;3146;3123;3115;3093;10366;10321;10247;10143;6620;6585;6558;6512;3746;3736;3689;3631;2143;2239;2360;2481;
1815035;"Ropczyce - obszar wiejski (5)";11198;11290;11316;11372;2489;2486;2457;2426;6991;7041;7068;7097;4757;4764;4767;4748;2234;2277;2301;2349;1718;1763;1791;1849;
1815043;"Sędziszów Małopolski (3)";23337;23387;23476;23502;4946;4897;4870;4809;14481;14468;14487;14480;9602;9606;9559;9513;4879;4862;4928;4967;3910;4022;4119;4213;
1815044;"Sędziszów Małopolski - miasto (4)";7481;7492;7492;7528;1467;1462;1444;1470;4664;4606;4565;4527;3091;3069;3039;2994;1573;1537;1526;1533;1350;1424;1483;1531;
1815045;"Sędziszów Małopolski - obszar wiejski (5)";15856;15895;15984;15974;3479;3435;3426;3339;9817;9862;9922;9953;6511;6537;6520;6519;3306;3325;3402;3434;2560;2598;2636;2682;
1815052;"Wielopole Skrzyńskie (2)";8431;8394;8357;8308;1912;1885;1832;1800;5121;5128;5125;5110;3434;3397;3374;3344;1687;1731;1751;1766;1398;1381;1400;1398;
1816011;"Dynów (1)";6195;6186;6178;6168;1198;1172;1158;1142;3960;3953;3949;3917;2521;2508;2500;2467;1439;1445;1449;1450;1037;1061;1071;1109;
1816023;"Błażowa (3)";10830;10834;10830;10817;2163;2099;2046;2001;6642;6701;6748;6751;4307;4309;4320;4312;2335;2392;2428;2439;2025;2034;2036;2065;
1816024;"Błażowa - miasto (4)";2182;2178;2188;2169;404;387;384;358;1407;1409;1409;1398;876;877;891;900;531;532;518;498;371;382;395;413;
1816025;"Błażowa - obszar wiejski (5)";8648;8656;8642;8648;1759;1712;1662;1643;5235;5292;5339;5353;3431;3432;3429;3412;1804;1860;1910;1941;1654;1652;1641;1652;
1816033;"Boguchwała (3)";19210;19459;19753;19952;3797;3844;3902;3949;12195;12330;12458;12521;7984;8064;8173;8186;4211;4266;4285;4335;3218;3285;3393;3482;
1816034;"Boguchwała - miasto (4)";5796;5865;5905;5971;1040;1034;1035;1056;3721;3775;3786;3788;2343;2383;2394;2394;1378;1392;1392;1394;1035;1056;1084;1127;
1816035;"Boguchwała - obszar wiejski (5)";13414;13594;13848;13981;2757;2810;2867;2893;8474;8555;8672;8733;5641;5681;5779;5792;2833;2874;2893;2941;2183;2229;2309;2355;
1816042;"Chmielnik (2)";6706;6762;6779;6805;1459;1436;1401;1386;4123;4177;4191;4224;2710;2747;2735;2735;1413;1430;1456;1489;1124;1149;1187;1195;
1816052;"Dynów (2)";7042;7034;7007;6966;1428;1401;1356;1306;4308;4296;4306;4323;2850;2832;2826;2799;1458;1464;1480;1524;1306;1337;1345;1337;
1816063;"Głogów Małopolski (3)";19032;19223;19407;19547;4061;4076;4081;4079;12152;12276;12369;12415;7997;8043;8104;8100;4155;4233;4265;4315;2819;2871;2957;3053;
1816064;"Głogów Małopolski - miasto (4)";6014;6117;6190;6258;1345;1379;1369;1368;3932;3962;3999;4024;2581;2611;2652;2668;1351;1351;1347;1356;737;776;822;866;
1816065;"Głogów Małopolski - obszar wiejski (5)";13018;13106;13217;13289;2716;2697;2712;2711;8220;8314;8370;8391;5416;5432;5452;5432;2804;2882;2918;2959;2082;2095;2135;2187;
1816072;"Hyżne (2)";6996;6968;6994;7008;1520;1473;1469;1439;4317;4321;4316;4341;2918;2908;2887;2892;1399;1413;1429;1449;1159;1174;1209;1228;
1816082;"Kamień (2)";6971;6947;6889;6848;1552;1477;1405;1347;4358;4393;4392;4421;2967;2980;2952;2933;1391;1413;1440;1488;1061;1077;1092;1080;
1816092;"Krasne (2)";10543;10659;10735;10877;2237;2217;2228;2241;6625;6730;6761;6853;4386;4455;4467;4508;2239;2275;2294;2345;1681;1712;1746;1783;
1816102;"Lubenia (2)";6518;6504;6455;6448;1257;1253;1194;1189;4035;4032;4017;4010;2574;2540;2515;2506;1461;1492;1502;1504;1226;1219;1244;1249;
1816113;"Sokołów Małopolski (3)";16988;17038;17058;17090;3670;3608;3575;3516;10629;10711;10705;10750;7108;7154;7124;7150;3521;3557;3581;3600;2689;2719;2778;2824;
1816114;"Sokołów Małopolski - miasto (4)";4028;4040;4047;4092;762;768;763;779;2734;2716;2680;2679;1755;1757;1751;1751;979;959;929;928;532;556;604;634;
1816115;"Sokołów Małopolski - obszar wiejski (5)";12960;12998;13011;12998;2908;2840;2812;2737;7895;7995;8025;8071;5353;5397;5373;5399;2542;2598;2652;2672;2157;2163;2174;2190;
1816122;"Świlcza (2)";16134;16192;16271;16282;3279;3295;3227;3173;10217;10214;10300;10308;6791;6751;6823;6776;3426;3463;3477;3532;2638;2683;2744;2801;
1816132;"Trzebownisko (2)";20315;20565;20787;20978;4366;4376;4371;4376;13022;13175;13295;13393;8625;8667;8719;8722;4397;4508;4576;4671;2927;3014;3121;3209;
1816143;"Tyczyn (3)";11285;11464;11500;11556;2410;2467;2435;2428;7106;7161;7145;7179;4758;4794;4758;4739;2348;2367;2387;2440;1769;1836;1920;1949;
1816144;"Tyczyn - miasto (4)";3602;3641;3638;3662;739;754;741;742;2330;2332;2299;2303;1504;1512;1494;1490;826;820;805;813;533;555;598;617;
1816145;"Tyczyn - obszar wiejski (5)";7683;7823;7862;7894;1671;1713;1694;1686;4776;4829;4846;4876;3254;3282;3264;3249;1522;1547;1582;1627;1236;1281;1322;1332;
1817011;"Sanok (1)";39375;39027;38818;38486;6781;6687;6534;6298;25751;25200;24774;24290;15530;15229;15071;14874;10221;9971;9703;9416;6843;7140;7510;7898;
1817022;"Besko (2)";4431;4482;4505;4488;986;1004;994;967;2817;2817;2826;2822;1905;1910;1902;1887;912;907;924;935;628;661;685;699;
1817032;"Bukowsko (2)";5516;5539;5555;5544;1212;1204;1179;1182;3482;3507;3523;3490;2243;2263;2271;2250;1239;1244;1252;1240;822;828;853;872;
1817042;"Komańcza (2)";5061;5014;4991;4933;864;815;794;759;3403;3361;3317;3260;2087;2057;2033;2033;1316;1304;1284;1227;794;838;880;914;
1817052;"Sanok (2)";17627;17677;17686;17810;3734;3677;3628;3586;11008;11043;11062;11157;7201;7204;7184;7232;3807;3839;3878;3925;2885;2957;2996;3067;
1817062;"Tyrawa Wołoska (2)";1999;2002;1986;1986;464;451;432;410;1265;1274;1271;1287;834;845;830;832;431;429;441;455;270;277;283;289;
1817073;"Zagórz (3)";13064;13014;12999;13036;2553;2485;2434;2409;8463;8415;8383;8337;5377;5340;5316;5293;3086;3075;3067;3044;2048;2114;2182;2290;
1817074;"Zagórz - miasto (4)";5100;5082;5073;5082;912;915;904;888;3365;3321;3290;3267;2097;2077;2039;2041;1268;1244;1251;1226;823;846;879;927;
1817075;"Zagórz - obszar wiejski (5)";7964;7932;7926;7954;1641;1570;1530;1521;5098;5094;5093;5070;3280;3263;3277;3252;1818;1831;1816;1818;1225;1268;1303;1363;
1817082;"Zarszyn (2)";9252;9341;9286;9362;1795;1835;1747;1769;5792;5836;5853;5898;3712;3734;3713;3731;2080;2102;2140;2167;1665;1670;1686;1695;
1818011;"Stalowa Wola (1)";64189;63692;63291;62924;10535;10294;10097;9903;42358;41417;40493;39661;25725;25379;25086;24726;16633;16038;15407;14935;11296;11981;12701;13360;
1818022;"Bojanów (2)";7489;7482;7470;7489;1650;1592;1511;1467;4803;4830;4880;4915;3237;3232;3250;3264;1566;1598;1630;1651;1036;1060;1079;1107;
1818032;"Pysznica (2)";10367;10480;10557;10650;1997;1967;1922;1909;6764;6863;6929;6983;4307;4353;4370;4377;2457;2510;2559;2606;1606;1650;1706;1758;
1818042;"Radomyśl nad Sanem (2)";7413;7397;7378;7342;1434;1400;1360;1305;4666;4671;4672;4670;2964;2942;2933;2931;1702;1729;1739;1739;1313;1326;1346;1367;
1818052;"Zaklików (2)";8734;8709;;;1605;1554;;;5518;5503;;;3485;3493;;;2033;2010;;;1611;1652;;;
1818053;"Zaklików (3)";;;8685;8675;;;1499;1485;;;5491;5442;;;3489;3446;;;2002;1996;;;1695;1748;
1818054;"Zaklików - miasto (4)";;;3064;3061;;;536;530;;;1904;1888;;;1208;1192;;;696;696;;;624;643;
1818055;"Zaklików - obszar wiejski (5)";;;5621;5614;;;963;955;;;3587;3554;;;2281;2254;;;1306;1300;;;1071;1105;
1818062;"Zaleszany (2)";10919;10904;10899;10866;2144;2111;2076;2024;6912;6879;6885;6852;4442;4431;4435;4399;2470;2448;2450;2453;1863;1914;1938;1990;
1819012;"Czudec (2)";11777;11721;11723;11788;2404;2333;2310;2265;7380;7405;7403;7445;4831;4793;4781;4811;2549;2612;2622;2634;1993;1983;2010;2078;
1819022;"Frysztak (2)";10558;10524;10504;10537;2246;2172;2103;2064;6606;6640;6659;6695;4305;4328;4332;4346;2301;2312;2327;2349;1706;1712;1742;1778;
1819032;"Niebylec (2)";10651;10620;10567;10515;2159;2127;2045;1982;6634;6625;6656;6635;4381;4331;4320;4281;2253;2294;2336;2354;1858;1868;1866;1898;
1819043;"Strzyżów (3)";20911;20925;20850;20778;3890;3810;3740;3646;13396;13387;13313;13241;8618;8622;8529;8476;4778;4765;4784;4765;3625;3728;3797;3891;
1819044;"Strzyżów - miasto (4)";8930;8967;8955;8925;1606;1586;1555;1523;5766;5744;5708;5642;3680;3698;3668;3640;2086;2046;2040;2002;1558;1637;1692;1760;
1819045;"Strzyżów - obszar wiejski (5)";11981;11958;11895;11853;2284;2224;2185;2123;7630;7643;7605;7599;4938;4924;4861;4836;2692;2719;2744;2763;2067;2091;2105;2131;
1819052;"Wiśniowa (2)";8365;8305;8268;8234;1763;1709;1654;1606;5200;5192;5194;5192;3379;3356;3357;3340;1821;1836;1837;1852;1402;1404;1420;1436;
1820013;"Baranów Sandomierski (3)";12130;12051;12007;12028;2364;2258;2164;2101;7642;7653;7664;7683;4878;4859;4825;4839;2764;2794;2839;2844;2124;2140;2179;2244;
1820014;"Baranów Sandomierski - miasto (4)";1508;1497;1463;1485;271;266;247;248;950;942;915;925;572;564;554;574;378;378;361;351;287;289;301;312;
1820015;"Baranów Sandomierski - obszar wiejski (5)";10622;10554;10544;10543;2093;1992;1917;1853;6692;6711;6749;6758;4306;4295;4271;4265;2386;2416;2478;2493;1837;1851;1878;1932;
1820022;"Gorzyce (2)";13505;13464;13480;13402;2602;2508;2523;2444;8928;8890;8763;8659;5666;5662;5596;5564;3262;3228;3167;3095;1975;2066;2194;2299;
1820032;"Grębów (2)";9820;9852;9858;9878;2039;1994;1941;1892;6073;6121;6182;6199;4062;4074;4119;4121;2011;2047;2063;2078;1708;1737;1735;1787;
1820043;"Nowa Dęba (3)";18579;18551;18453;18403;3185;3118;3029;2990;12177;12089;11991;11840;7647;7562;7534;7412;4530;4527;4457;4428;3217;3344;3433;3573;
1820044;"Nowa Dęba - miasto (4)";11507;11507;11403;11359;1855;1834;1774;1762;7651;7593;7488;7367;4729;4680;4641;4538;2922;2913;2847;2829;2001;2080;2141;2230;
1820045;"Nowa Dęba - obszar wiejski (5)";7072;7044;7050;7044;1330;1284;1255;1228;4526;4496;4503;4473;2918;2882;2893;2874;1608;1614;1610;1599;1216;1264;1292;1343;
1821012;"Baligród (2)";3207;3191;3220;3188;608;585;575;545;2044;2031;2055;2048;1280;1279;1293;1280;764;752;762;768;555;575;590;595;
1821022;"Cisna (2)";1725;1730;1726;1757;280;262;238;244;1176;1189;1202;1214;728;739;746;756;448;450;456;458;269;279;286;299;
1821033;"Lesko (3)";11561;11544;11556;11516;2203;2232;2217;2180;7348;7226;7137;7077;4555;4469;4398;4360;2793;2757;2739;2717;2010;2086;2202;2259;
1821034;"Lesko - miasto (4)";5674;5629;5615;5590;1030;1080;1066;1065;3628;3480;3406;3335;2229;2125;2083;2037;1399;1355;1323;1298;1016;1069;1143;1190;
1821035;"Lesko - obszar wiejski (5)";5887;5915;5941;5926;1173;1152;1151;1115;3720;3746;3731;3742;2326;2344;2315;2323;1394;1402;1416;1419;994;1017;1059;1069;
1821042;"Olszanica (2)";4991;5005;4994;4998;918;921;900;865;3248;3230;3202;3228;2114;2092;2062;2089;1134;1138;1140;1139;825;854;892;905;
1821052;"Solina (2)";5344;5313;5325;5288;966;902;895;850;3491;3485;3479;3461;2184;2187;2161;2164;1307;1298;1318;1297;887;926;951;977;
1861011;"Krosno (1)";47307;47223;46934;46775;8068;8052;7901;7823;30198;29686;29189;28679;18494;18273;18112;17896;11704;11413;11077;10783;9041;9485;9844;10273;
1862011;"Przemyśl (1)";64276;63638;63441;62720;10906;10651;10523;10165;40755;39985;39432;38777;24777;24354;24158;23788;15978;15631;15274;14989;12615;13002;13486;13778;
1863011;"Rzeszów (1)";182028;183108;185123;185896;31375;32040;32433;32900;119322;118431;118705;117746;77546;77400;78486;78263;41776;41031;40219;39483;31331;32637;33985;35250;
1864011;"Tarnobrzeg (1)";48558;48217;48000;47816;8199;7989;7758;7605;31208;30671;30248;29868;19017;18708;18399;18143;12191;11963;11849;11725;9151;9557;9994;10343;
2001011;"Augustów (1)";30809;30610;30482;30400;5558;5427;5328;5221;19742;19544;19354;19232;12362;12174;11959;11815;7380;7370;7395;7417;5509;5639;5800;5947;
2001022;"Augustów (2)";6904;6949;6913;6861;1533;1496;1450;1393;4265;4329;4323;4315;2829;2875;2864;2839;1436;1454;1459;1476;1106;1124;1140;1153;
2001032;"Bargłów Kościelny (2)";5800;5736;5700;5691;1231;1181;1144;1128;3502;3496;3468;3482;2279;2283;2274;2283;1223;1213;1194;1199;1067;1059;1088;1081;
2001043;"Lipsk (3)";5489;5419;5407;5359;961;880;865;830;3425;3436;3430;3382;2083;2101;2091;2070;1342;1335;1339;1312;1103;1103;1112;1147;
2001044;"Lipsk - miasto (4)";2476;2443;2440;2407;400;366;361;347;1742;1714;1701;1643;983;980;976;940;759;734;725;703;334;363;378;417;
2001045;"Lipsk - obszar wiejski (5)";3013;2976;2967;2952;561;514;504;483;1683;1722;1729;1739;1100;1121;1115;1130;583;601;614;609;769;740;734;730;
2001052;"Nowinka (2)";2972;2957;2977;2934;613;595;588;554;1824;1817;1827;1806;1184;1185;1179;1166;640;632;648;640;535;545;562;574;
2001062;"Płaska (2)";2589;2634;2650;2641;457;469;458;446;1588;1624;1641;1644;1001;1030;1054;1055;587;594;587;589;544;541;551;551;
2001072;"Sztabin (2)";5310;5253;5245;5217;1023;965;923;896;3249;3252;3267;3270;2014;2004;2001;1978;1235;1248;1266;1292;1038;1036;1055;1051;
2002013;"Choroszcz (3)";14303;14504;14579;14713;2740;2744;2718;2721;9299;9391;9393;9431;5858;5920;5909;5951;3441;3471;3484;3480;2264;2369;2468;2561;
2002014;"Choroszcz - miasto (4)";5728;5782;5759;5789;1030;1029;994;998;3737;3738;3702;3672;2319;2323;2306;2307;1418;1415;1396;1365;961;1015;1063;1119;
2002015;"Choroszcz - obszar wiejski (5)";8575;8722;8820;8924;1710;1715;1724;1723;5562;5653;5691;5759;3539;3597;3603;3644;2023;2056;2088;2115;1303;1354;1405;1442;
2002023;"Czarna Białostocka (3)";11817;11763;11671;11601;2098;2083;2041;1978;7613;7525;7413;7320;4800;4737;4654;4604;2813;2788;2759;2716;2106;2155;2217;2303;
2002024;"Czarna Białostocka - miasto (4)";9737;9671;9594;9525;1716;1691;1648;1603;6354;6263;6162;6067;3989;3933;3854;3811;2365;2330;2308;2256;1667;1717;1784;1855;
2002025;"Czarna Białostocka - obszar wiejski (5)";2080;2092;2077;2076;382;392;393;375;1259;1262;1251;1253;811;804;800;793;448;458;451;460;439;438;433;448;
2002032;"Dobrzyniewo Duże (2)";8618;8698;8802;8895;1746;1745;1761;1763;5557;5596;5633;5667;3548;3557;3579;3593;2009;2039;2054;2074;1315;1357;1408;1465;
2002042;"Gródek (2)";5600;5531;5488;5408;856;810;818;808;3336;3317;3274;3202;1978;1978;1947;1907;1358;1339;1327;1295;1408;1404;1396;1398;
2002052;"Juchnowiec Kościelny (2)";15048;15292;15458;15671;3049;3101;3084;3127;9936;10052;10197;10287;6352;6414;6492;6514;3584;3638;3705;3773;2063;2139;2177;2257;
2002063;"Łapy (3)";22680;22511;22300;22243;3761;3633;3521;3494;14734;14577;14382;14154;9016;8945;8837;8705;5718;5632;5545;5449;4185;4301;4397;4595;
2002064;"Łapy - miasto (4)";16124;16005;15879;15812;2587;2498;2453;2425;10736;10582;10373;10171;6478;6432;6304;6240;4258;4150;4069;3931;2801;2925;3053;3216;
2002065;"Łapy - obszar wiejski (5)";6556;6506;6421;6431;1174;1135;1068;1069;3998;3995;4009;3983;2538;2513;2533;2465;1460;1482;1476;1518;1384;1376;1344;1379;
2002073;"Michałowo (3)";7138;7057;6976;6876;1057;1009;980;960;4227;4215;4177;4101;2458;2436;2423;2379;1769;1779;1754;1722;1854;1833;1819;1815;
2002074;"Michałowo - miasto (4)";3221;3177;3153;3123;538;499;481;479;2071;2053;2042;1993;1269;1264;1266;1237;802;789;776;756;612;625;630;651;
2002075;"Michałowo - obszar wiejski (5)";3917;3880;3823;3753;519;510;499;481;2156;2162;2135;2108;1189;1172;1157;1142;967;990;978;966;1242;1208;1189;1164;
2002082;"Poświętne (2)";3658;3640;3604;3548;745;693;663;630;2170;2195;2190;2156;1378;1388;1384;1354;792;807;806;802;743;752;751;762;
2002093;"Supraśl (3)";14151;14342;14379;14520;2731;2757;2711;2739;9283;9386;9405;9441;5760;5817;5815;5773;3523;3569;3590;3668;2137;2199;2263;2340;
2002094;"Supraśl - miasto (4)";4673;4679;4633;4635;779;800;772;785;3050;3002;2962;2941;1846;1818;1781;1755;1204;1184;1181;1186;844;877;899;909;
2002095;"Supraśl - obszar wiejski (5)";9478;9663;9746;9885;1952;1957;1939;1954;6233;6384;6443;6500;3914;3999;4034;4018;2319;2385;2409;2482;1293;1322;1364;1431;
2002103;"Suraż (3)";2079;2054;2033;2010;410;385;371;362;1212;1223;1224;1212;779;794;782;775;433;429;442;437;457;446;438;436;
2002104;"Suraż - miasto (4)";1012;1008;1009;999;218;206;198;191;614;623;631;625;395;410;416;417;219;213;215;208;180;179;180;183;
2002105;"Suraż - obszar wiejski (5)";1067;1046;1024;1011;192;179;173;171;598;600;593;587;384;384;366;358;214;216;227;229;277;267;258;253;
2002112;"Turośń Kościelna (2)";5892;5948;6047;6043;1242;1241;1238;1196;3676;3724;3806;3809;2297;2303;2353;2374;1379;1421;1453;1435;974;983;1003;1038;
2002123;"Tykocin (3)";6440;6435;6404;6371;1189;1160;1134;1097;3963;3985;3979;3984;2545;2551;2544;2549;1418;1434;1435;1435;1288;1290;1291;1290;
2002124;"Tykocin - miasto (4)";2010;2014;2012;1998;341;343;337;323;1288;1286;1289;1291;818;809;819;829;470;477;470;462;381;385;386;384;
2002125;"Tykocin - obszar wiejski (5)";4430;4421;4392;4373;848;817;797;774;2675;2699;2690;2693;1727;1742;1725;1720;948;957;965;973;907;905;905;906;
2002133;"Wasilków (3)";14943;15184;15465;15609;3020;3064;3098;3094;9766;9870;10031;10114;6425;6477;6614;6649;3341;3393;3417;3465;2157;2250;2336;2401;
2002134;"Wasilków - miasto (4)";10326;10511;10677;10707;2039;2088;2112;2086;6818;6894;6978;6974;4547;4574;4652;4632;2271;2320;2326;2342;1469;1529;1587;1647;
2002135;"Wasilków - obszar wiejski (5)";4617;4673;4788;4902;981;976;986;1008;2948;2976;3053;3140;1878;1903;1962;2017;1070;1073;1091;1123;688;721;749;754;
2002143;"Zabłudów (3)";9158;9173;9159;9187;1699;1674;1651;1643;5740;5774;5733;5752;3607;3620;3590;3601;2133;2154;2143;2151;1719;1725;1775;1792;
2002144;"Zabłudów - miasto (4)";2504;2495;2499;2506;473;451;441;428;1678;1683;1684;1695;1113;1098;1089;1093;565;585;595;602;353;361;374;383;
2002145;"Zabłudów - obszar wiejski (5)";6654;6678;6660;6681;1226;1223;1210;1215;4062;4091;4049;4057;2494;2522;2501;2508;1568;1569;1548;1549;1366;1364;1401;1409;
2002152;"Zawady (2)";2863;2846;2865;2822;539;481;478;445;1763;1802;1817;1820;1137;1166;1170;1153;626;636;647;667;561;563;570;557;
2003011;"Bielsk Podlaski (1)";26525;26336;26249;26075;4461;4350;4310;4227;17576;17345;17132;16868;10491;10297;10126;9945;7085;7048;7006;6923;4488;4641;4807;4980;
2003021;"Brańsk (1)";3876;3867;3854;3806;711;697;695;685;2477;2474;2450;2400;1536;1553;1531;1498;941;921;919;902;688;696;709;721;
2003032;"Bielsk Podlaski (2)";7097;7070;6966;6851;1024;1035;1020;1000;3532;3548;3527;3518;2125;2101;2068;2090;1407;1447;1459;1428;2541;2487;2419;2333;
2003042;"Boćki (2)";4676;4646;4581;4528;783;761;726;714;2552;2554;2544;2519;1517;1531;1529;1517;1035;1023;1015;1002;1341;1331;1311;1295;
2003052;"Brańsk (2)";6196;6112;6027;5958;1192;1107;1058;1025;3526;3543;3528;3517;2237;2265;2266;2242;1289;1278;1262;1275;1478;1462;1441;1416;
2003062;"Orla (2)";2975;2933;2913;2868;358;353;365;369;1393;1374;1362;1328;812;811;812;783;581;563;550;545;1224;1206;1186;1171;
2003072;"Rudka (2)";2007;1984;1950;1934;406;387;347;340;1171;1156;1172;1161;749;728;740;726;422;428;432;435;430;441;431;433;
2003082;"Wyszki (2)";4705;4651;4604;4542;877;845;814;782;2627;2619;2621;2600;1688;1682;1669;1664;939;937;952;936;1201;1187;1169;1160;
2004011;"Grajewo (1)";22375;22246;22243;22171;4101;4014;3895;3823;14963;14738;14691;14536;9377;9211;9154;9051;5586;5527;5537;5485;3311;3494;3657;3812;
2004022;"Grajewo (2)";6058;6027;5984;5946;1402;1354;1302;1261;3715;3727;3733;3720;2423;2396;2396;2382;1292;1331;1337;1338;941;946;949;965;
2004032;"Radziłów (2)";4979;4951;4908;4852;960;908;880;865;3059;3095;3074;3042;1924;1950;1934;1903;1135;1145;1140;1139;960;948;954;945;
2004043;"Rajgród (3)";5463;5418;5407;5366;1081;1000;975;924;3410;3431;3439;3425;2165;2191;2184;2166;1245;1240;1255;1259;972;987;993;1017;
2004044;"Rajgród - miasto (4)";1659;1626;1625;1620;265;239;238;232;1094;1070;1070;1064;632;618;607;602;462;452;463;462;300;317;317;324;
2004045;"Rajgród - obszar wiejski (5)";3804;3792;3782;3746;816;761;737;692;2316;2361;2369;2361;1533;1573;1577;1564;783;788;792;797;672;670;676;693;
2004053;"Szczuczyn (3)";6409;6381;6258;6230;1295;1267;1198;1180;4052;4032;3965;3936;2507;2490;2425;2403;1545;1542;1540;1533;1062;1082;1095;1114;
2004054;"Szczuczyn - miasto (4)";3459;3489;3449;3450;627;622;585;578;2272;2288;2274;2272;1395;1411;1403;1399;877;877;871;873;560;579;590;600;
2004055;"Szczuczyn - obszar wiejski (5)";2950;2892;2809;2780;668;645;613;602;1780;1744;1691;1664;1112;1079;1022;1004;668;665;669;660;502;503;505;514;
2004062;"Wąsosz (2)";3941;3893;3843;3792;840;806;779;739;2373;2353;2342;2336;1532;1516;1496;1478;841;837;846;858;728;734;722;717;
2005011;"Hajnówka (1)";21834;21559;21422;21275;3410;3297;3232;3195;14071;13805;13593;13341;8066;7965;7886;7788;6005;5840;5707;5553;4353;4457;4597;4739;
2005022;"Białowieża (2)";2300;2298;2281;2265;353;397;393;373;1351;1299;1271;1289;776;720;714;732;575;579;557;557;596;602;617;603;
2005032;"Czeremcha (2)";3460;3404;3385;3319;479;459;455;434;2093;2056;2023;1968;1156;1140;1130;1097;937;916;893;871;888;889;907;917;
2005042;"Czyże (2)";2298;2247;2182;2116;279;267;259;246;1126;1110;1083;1051;638;644;628;611;488;466;455;440;893;870;840;819;
2005052;"Dubicze Cerkiewne (2)";1682;1661;1615;1601;176;171;160;156;778;786;765;768;420;422;422;428;358;364;343;340;728;704;690;677;
2005062;"Hajnówka (2)";3999;3953;3922;3924;587;548;543;546;2332;2330;2316;2343;1347;1341;1339;1364;985;989;977;979;1080;1075;1063;1035;
2005073;"Kleszczele (3)";2740;2722;2662;2628;361;350;331;333;1489;1491;1456;1430;814;812;804;793;675;679;652;637;890;881;875;865;
2005074;"Kleszczele - miasto (4)";1368;1345;1321;1310;203;189;176;177;832;820;807;788;452;441;449;441;380;379;358;347;333;336;338;345;
2005075;"Kleszczele - obszar wiejski (5)";1372;1377;1341;1318;158;161;155;156;657;671;649;642;362;371;355;352;295;300;294;290;557;545;537;520;
2005082;"Narew (2)";3832;3747;3684;3636;537;502;491;465;2112;2086;2054;2048;1207;1192;1161;1167;905;894;893;881;1183;1159;1139;1123;
2005092;"Narewka (2)";3839;3824;3804;3803;485;485;480;478;2343;2338;2335;2312;1329;1324;1337;1324;1014;1014;998;988;1011;1001;989;1013;
2006011;"Kolno (1)";10679;10579;10567;10483;1864;1787;1753;1683;7316;7239;7183;7085;4458;4372;4298;4237;2858;2867;2885;2848;1499;1553;1631;1715;
2006022;"Grabowo (2)";3668;3640;3576;3580;788;741;695;685;2255;2274;2250;2270;1458;1466;1445;1442;797;808;805;828;625;625;631;625;
2006032;"Kolno (2)";8876;8791;8797;8751;2054;1961;1913;1860;5276;5323;5353;5375;3525;3554;3571;3551;1751;1769;1782;1824;1546;1507;1531;1516;
2006042;"Mały Płock (2)";5031;4977;4934;4900;1000;954;908;879;3156;3152;3148;3128;2040;2013;1981;1951;1116;1139;1167;1177;875;871;878;893;
2006053;"Stawiski (3)";6464;6404;6373;6306;1295;1228;1193;1146;4009;4026;4013;3980;2666;2664;2634;2595;1343;1362;1379;1385;1160;1150;1167;1180;
2006054;"Stawiski - miasto (4)";2410;2379;2342;2306;438;426;401;388;1600;1580;1553;1524;1005;986;960;942;595;594;593;582;372;373;388;394;
2006055;"Stawiski - obszar wiejski (5)";4054;4025;4031;4000;857;802;792;758;2409;2446;2460;2456;1661;1678;1674;1653;748;768;786;803;788;777;779;786;
2006062;"Turośl (2)";5210;5164;5122;5142;1254;1192;1164;1138;3099;3125;3113;3166;2159;2151;2116;2128;940;974;997;1038;857;847;845;838;
2007013;"Jedwabne (3)";5612;5542;5478;5423;1078;1027;993;960;3539;3511;3485;3436;2275;2259;2228;2197;1264;1252;1257;1239;995;1004;1000;1027;
2007014;"Jedwabne - miasto (4)";1738;1717;1673;1652;345;341;322;313;1167;1153;1133;1107;743;731;716;698;424;422;417;409;226;223;218;232;
2007015;"Jedwabne - obszar wiejski (5)";3874;3825;3805;3771;733;686;671;647;2372;2358;2352;2329;1532;1528;1512;1499;840;830;840;830;769;781;782;795;
2007022;"Łomża (2)";10813;10753;10801;10835;2336;2261;2227;2163;6874;6855;6911;6968;4354;4326;4334;4364;2520;2529;2577;2604;1603;1637;1663;1704;
2007032;"Miastkowo (2)";4337;4332;4341;4317;1015;975;961;925;2681;2692;2718;2715;1788;1801;1818;1787;893;891;900;928;641;665;662;677;
2007043;"Nowogród (3)";4176;4139;4117;4089;882;843;815;801;2603;2600;2604;2580;1685;1688;1702;1654;918;912;902;926;691;696;698;708;
2007044;"Nowogród - miasto (4)";2191;2197;2187;2172;488;471;452;445;1397;1414;1417;1405;894;912;926;899;503;502;491;506;306;312;318;322;
2007045;"Nowogród - obszar wiejski (5)";1985;1942;1930;1917;394;372;363;356;1206;1186;1187;1175;791;776;776;755;415;410;411;420;385;384;380;386;
2007052;"Piątnica (2)";10771;10736;10720;10718;2268;2216;2137;2104;6769;6751;6791;6790;4397;4338;4354;4334;2372;2413;2437;2456;1734;1769;1792;1824;
2007062;"Przytuły (2)";2180;2187;2167;2166;435;408;405;404;1353;1380;1372;1376;875;904;882;872;478;476;490;504;392;399;390;386;
2007072;"Śniadowo (2)";5580;5562;5521;5476;1148;1110;1074;1059;3350;3377;3380;3336;2121;2135;2133;2110;1229;1242;1247;1226;1082;1075;1067;1081;
2007082;"Wizna (2)";4312;4249;4165;4161;852;784;740;732;2590;2601;2573;2589;1662;1675;1647;1634;928;926;926;955;870;864;852;840;
2007092;"Zbójna (2)";4388;4360;4300;4254;876;839;811;772;2717;2720;2697;2685;1779;1770;1721;1702;938;950;976;983;795;801;792;797;
2008013;"Goniądz (3)";5159;5116;5071;5063;965;937;933;927;3202;3173;3138;3129;2004;1991;1966;1959;1198;1182;1172;1170;992;1006;1000;1007;
2008014;"Goniądz - miasto (4)";1902;1900;1892;1869;338;353;361;357;1207;1182;1176;1155;737;719;709;691;470;463;467;464;357;365;355;357;
2008015;"Goniądz - obszar wiejski (5)";3257;3216;3179;3194;627;584;572;570;1995;1991;1962;1974;1267;1272;1257;1268;728;719;705;706;635;641;645;650;
2008022;"Jasionówka (2)";2932;2939;2884;2855;529;502;467;456;1821;1842;1823;1811;1141;1159;1140;1129;680;683;683;682;582;595;594;588;
2008032;"Jaświły (2)";5327;5224;5154;5092;963;889;847;803;3224;3227;3209;3189;2018;2020;2008;1992;1206;1207;1201;1197;1140;1108;1098;1100;
2008043;"Knyszyn (3)";4908;4892;4910;4893;887;863;841;791;3138;3143;3181;3187;2030;2022;2038;2048;1108;1121;1143;1139;883;886;888;915;
2008044;"Knyszyn - miasto (4)";2851;2850;2853;2840;497;497;487;448;1873;1868;1879;1878;1181;1173;1173;1186;692;695;706;692;481;485;487;514;
2008045;"Knyszyn - obszar wiejski (5)";2057;2042;2057;2053;390;366;354;343;1265;1275;1302;1309;849;849;865;862;416;426;437;447;402;401;401;401;
2008052;"Krypno (2)";4091;4069;4031;4047;824;793;757;741;2501;2521;2521;2533;1608;1631;1617;1640;893;890;904;893;766;755;753;773;
2008063;"Mońki (3)";15424;15338;15279;15155;2701;2623;2540;2450;9957;9907;9886;9778;6308;6210;6156;6079;3649;3697;3730;3699;2766;2808;2853;2927;
2008064;"Mońki - miasto (4)";10396;10352;10275;10174;1738;1730;1651;1576;6888;6794;6735;6623;4273;4144;4079;4010;2615;2650;2656;2613;1770;1828;1889;1975;
2008065;"Mońki - obszar wiejski (5)";5028;4986;5004;4981;963;893;889;874;3069;3113;3151;3155;2035;2066;2077;2069;1034;1047;1074;1086;996;980;964;952;
2008072;"Trzcianne (2)";4544;4499;4488;4439;852;806;779;778;2744;2742;2763;2711;1787;1802;1794;1752;957;940;969;959;948;951;946;950;
2009011;"Sejny (1)";5641;5650;5640;5583;1039;1052;1049;1010;3606;3543;3512;3437;2167;2132;2117;2070;1439;1411;1395;1367;996;1055;1079;1136;
2009022;"Giby (2)";2927;2904;2874;2834;533;514;469;454;1772;1760;1772;1757;1102;1111;1122;1081;670;649;650;676;622;630;633;623;
2009032;"Krasnopol (2)";3955;3912;3835;3874;768;748;711;711;2428;2394;2355;2384;1539;1517;1485;1510;889;877;870;874;759;770;769;779;
2009042;"Puńsk (2)";4308;4283;4283;4233;789;759;745;696;2707;2701;2708;2687;1702;1703;1705;1689;1005;998;1003;998;812;823;830;850;
2009052;"Sejny (2)";4132;4142;4146;4082;731;716;689;669;2568;2585;2605;2573;1616;1624;1655;1613;952;961;950;960;833;841;852;840;
2010011;"Siemiatycze (1)";14851;14766;14725;14684;2573;2465;2392;2316;9947;9864;9800;9711;5892;5849;5805;5751;4055;4015;3995;3960;2331;2437;2533;2657;
2010023;"Drohiczyn (3)";6730;6713;6640;6558;1273;1250;1160;1095;3995;4008;4009;3973;2469;2458;2461;2436;1526;1550;1548;1537;1462;1455;1471;1490;
2010024;"Drohiczyn - miasto (4)";2121;2125;2118;2065;336;329;320;287;1357;1351;1336;1317;814;811;801;772;543;540;535;545;428;445;462;461;
2010025;"Drohiczyn - obszar wiejski (5)";4609;4588;4522;4493;937;921;840;808;2638;2657;2673;2656;1655;1647;1660;1664;983;1010;1013;992;1034;1010;1009;1029;
2010032;"Dziadkowice (2)";2965;2924;2905;2887;558;507;480;470;1807;1803;1793;1788;1153;1164;1153;1139;654;639;640;649;600;614;632;629;
2010042;"Grodzisk (2)";4558;4494;4418;4348;878;810;754;713;2611;2630;2616;2589;1656;1655;1631;1625;955;975;985;964;1069;1054;1048;1046;
2010052;"Mielnik (2)";2579;2563;2543;2472;360;350;341;321;1476;1476;1467;1434;866;858;860;834;610;618;607;600;743;737;735;717;
2010062;"Milejczyce (2)";2015;1963;1928;1893;321;285;270;262;1044;1038;1033;1021;634;640;634;616;410;398;399;405;650;640;625;610;
2010072;"Nurzec-Stacja (2)";4271;4249;4176;4119;632;602;580;568;2444;2448;2411;2393;1488;1492;1443;1418;956;956;968;975;1195;1199;1185;1158;
2010082;"Perlejewo (2)";3036;2994;2954;2953;584;544;513;493;1770;1778;1787;1801;1111;1110;1108;1119;659;668;679;682;682;672;654;659;
2010092;"Siemiatycze (2)";6353;6272;6190;6158;1106;1062;1008;978;3795;3784;3794;3805;2386;2363;2349;2352;1409;1421;1445;1453;1452;1426;1388;1375;
2011013;"Dąbrowa Białostocka (3)";12398;12155;12054;11968;2229;2035;1977;1877;7652;7576;7531;7522;4715;4632;4562;4544;2937;2944;2969;2978;2517;2544;2546;2569;
2011014;"Dąbrowa Białostocka - miasto (4)";5991;5874;5796;5738;971;905;869;818;3884;3786;3709;3680;2370;2289;2224;2207;1514;1497;1485;1473;1136;1183;1218;1240;
2011015;"Dąbrowa Białostocka - obszar wiejski (5)";6407;6281;6258;6230;1258;1130;1108;1059;3768;3790;3822;3842;2345;2343;2338;2337;1423;1447;1484;1505;1381;1361;1328;1329;
2011022;"Janów (2)";4321;4310;4275;4220;820;786;760;741;2595;2602;2601;2560;1620;1641;1636;1592;975;961;965;968;906;922;914;919;
2011032;"Korycin (2)";3448;3396;3393;3359;699;658;638;611;2072;2058;2062;2069;1292;1283;1278;1290;780;775;784;779;677;680;693;679;
2011043;"Krynki (3)";3309;3283;3271;3217;486;448;454;452;2062;2064;2031;1981;1256;1259;1242;1221;806;805;789;760;761;771;786;784;
2011044;"Krynki - miasto (4)";2550;2511;2515;2485;391;357;360;357;1645;1634;1613;1576;978;970;969;961;667;664;644;615;514;520;542;552;
2011045;"Krynki - obszar wiejski (5)";759;772;756;732;95;91;94;95;417;430;418;405;278;289;273;260;139;141;145;145;247;251;244;232;
2011052;"Kuźnica (2)";4276;4236;4203;4129;757;720;717;688;2586;2585;2574;2547;1669;1657;1638;1603;917;928;936;944;933;931;912;894;
2011062;"Nowy Dwór (2)";2798;2796;2790;2731;457;440;436;429;1670;1685;1691;1654;1043;1061;1056;1025;627;624;635;629;671;671;663;648;
2011072;"Sidra (2)";3664;3644;3606;3568;597;580;546;537;2261;2250;2252;2232;1374;1374;1367;1353;887;876;885;879;806;814;808;799;
2011083;"Sokółka (3)";26465;26343;26270;26092;4771;4652;4553;4437;17193;17032;16908;16678;10745;10597;10518;10395;6448;6435;6390;6283;4501;4659;4809;4977;
2011084;"Sokółka - miasto (4)";18902;18765;18716;18594;3258;3185;3122;3039;12589;12377;12254;12046;7782;7646;7591;7504;4807;4731;4663;4542;3055;3203;3340;3509;
2011085;"Sokółka - obszar wiejski (5)";7563;7578;7554;7498;1513;1467;1431;1398;4604;4655;4654;4632;2963;2951;2927;2891;1641;1704;1727;1741;1446;1456;1469;1468;
2011093;"Suchowola (3)";7232;7180;7099;7065;1352;1299;1232;1195;4360;4360;4333;4326;2695;2683;2677;2649;1665;1677;1656;1677;1520;1521;1534;1544;
2011094;"Suchowola - miasto (4)";2272;2274;2236;2234;383;379;355;358;1431;1429;1409;1395;855;844;839;823;576;585;570;572;458;466;472;481;
2011095;"Suchowola - obszar wiejski (5)";4960;4906;4863;4831;969;920;877;837;2929;2931;2924;2931;1840;1839;1838;1826;1089;1092;1086;1105;1062;1055;1062;1063;
2011102;"Szudziałowo (2)";3217;3182;3099;3026;511;498;481;478;1869;1852;1801;1759;1106;1104;1053;1019;763;748;748;740;837;832;817;789;
2012012;"Bakałarzewo (2)";3077;3119;3092;3110;612;605;586;576;1940;1982;1966;1971;1203;1235;1244;1263;737;747;722;708;525;532;540;563;
2012022;"Filipów (2)";4524;4504;4454;4424;951;930;887;846;2797;2777;2741;2747;1785;1756;1739;1745;1012;1021;1002;1002;776;797;826;831;
2012032;"Jeleniewo (2)";3162;3133;3160;3144;705;670;661;625;1951;1932;1957;1978;1273;1265;1283;1289;678;667;674;689;506;531;542;541;
2012042;"Przerośl (2)";3059;3027;3049;3013;662;640;614;584;1816;1790;1836;1828;1173;1153;1183;1184;643;637;653;644;581;597;599;601;
2012052;"Raczki (2)";6071;6051;6027;6018;1318;1280;1266;1252;3794;3799;3767;3752;2418;2425;2409;2415;1376;1374;1358;1337;959;972;994;1014;
2012062;"Rutka-Tartak (2)";2470;2408;2409;2395;528;491;465;460;1488;1472;1483;1472;970;945;954;948;518;527;529;524;454;445;461;463;
2012072;"Suwałki (2)";7252;7292;7388;7457;1520;1486;1482;1458;4594;4666;4744;4817;2957;2951;2976;3033;1637;1715;1768;1784;1138;1140;1162;1182;
2012082;"Szypliszki (2)";3946;3952;3949;3968;837;792;765;770;2421;2457;2477;2474;1547;1570;1574;1550;874;887;903;924;688;703;707;724;
2012092;"Wiżajny (2)";2463;2438;2401;2403;503;478;439;441;1500;1493;1477;1463;936;938;924;908;564;555;553;555;460;467;485;499;
2013011;"Wysokie Mazowieckie (1)";9470;9503;9517;9443;1812;1809;1833;1803;6216;6186;6143;6016;3813;3797;3775;3731;2403;2389;2368;2285;1442;1508;1541;1624;
2013023;"Ciechanowiec (3)";9122;9063;9014;8914;1600;1569;1516;1419;5746;5720;5691;5668;3534;3519;3474;3449;2212;2201;2217;2219;1776;1774;1807;1827;
2013024;"Ciechanowiec - miasto (4)";4886;4840;4812;4764;855;863;832;765;3234;3165;3127;3103;1981;1934;1890;1880;1253;1231;1237;1223;797;812;853;896;
2013025;"Ciechanowiec - obszar wiejski (5)";4236;4223;4202;4150;745;706;684;654;2512;2555;2564;2565;1553;1585;1584;1569;959;970;980;996;979;962;954;931;
2013033;"Czyżew (3)";6590;6550;6521;6488;1359;1330;1295;1273;4029;3990;3980;3944;2533;2518;2514;2505;1496;1472;1466;1439;1202;1230;1246;1271;
2013034;"Czyżew - miasto (4)";2634;2636;2642;2634;525;513;503;501;1691;1679;1682;1659;1038;1036;1049;1035;653;643;633;624;418;444;457;474;
2013035;"Czyżew - obszar wiejski (5)";3956;3914;3879;3854;834;817;792;772;2338;2311;2298;2285;1495;1482;1465;1470;843;829;833;815;784;786;789;797;
2013042;"Klukowo (2)";4566;4557;4536;4503;890;871;840;821;2647;2666;2667;2655;1704;1715;1707;1707;943;951;960;948;1029;1020;1029;1027;
2013052;"Kobylin-Borzymy (2)";3419;3378;3350;3304;677;631;607;586;1983;1987;1992;1975;1257;1255;1239;1235;726;732;753;740;759;760;751;743;
2013062;"Kulesze Kościelne (2)";3255;3219;3184;3157;651;634;608;599;1956;1949;1932;1900;1260;1252;1244;1230;696;697;688;670;648;636;644;658;
2013072;"Nowe Piekuty (2)";4109;4090;4016;4009;852;818;794;802;2429;2437;2392;2369;1601;1604;1567;1546;828;833;825;823;828;835;830;838;
2013082;"Sokoły (2)";5915;5843;5826;5804;1118;1081;1062;1059;3672;3639;3626;3596;2329;2299;2300;2278;1343;1340;1326;1318;1125;1123;1138;1149;
2013093;"Szepietowo (3)";7303;7213;7190;7154;1462;1391;1373;1342;4416;4388;4376;4368;2764;2718;2704;2700;1652;1670;1672;1668;1425;1434;1441;1444;
2013094;"Szepietowo - miasto (4)";2322;2282;2278;2268;457;438;427;412;1481;1454;1461;1457;904;874;879;878;577;580;582;579;384;390;390;399;
2013095;"Szepietowo - obszar wiejski (5)";4981;4931;4912;4886;1005;953;946;930;2935;2934;2915;2911;1860;1844;1825;1822;1075;1090;1090;1089;1041;1044;1051;1045;
2013102;"Wysokie Mazowieckie (2)";5405;5377;5365;5401;1134;1104;1078;1072;3235;3238;3251;3295;2119;2131;2131;2158;1116;1107;1120;1137;1036;1035;1036;1034;
2014011;"Zambrów (1)";22643;22451;22262;22206;4112;4024;3888;3792;14762;14566;14407;14314;8993;8807;8683;8670;5769;5759;5724;5644;3769;3861;3967;4100;
2014022;"Kołaki Kościelne (2)";2429;2414;2399;2380;473;463;461;446;1502;1491;1477;1467;965;955;937;928;537;536;540;539;454;460;461;467;
2014032;"Rutki (2)";5875;5801;5805;5762;1182;1133;1126;1072;3684;3669;3655;3654;2381;2357;2336;2333;1303;1312;1319;1321;1009;999;1024;1036;
2014042;"Szumowo (2)";4982;4978;4983;4941;1055;1043;1043;1006;3043;3058;3050;3045;1957;1969;1981;1955;1086;1089;1069;1090;884;877;890;890;
2014052;"Zambrów (2)";8988;8982;9006;9010;1972;1935;1914;1909;5449;5460;5519;5527;3524;3519;3558;3518;1925;1941;1961;2009;1567;1587;1573;1574;
2061011;"Białystok (1)";294921;295282;295459;295981;49573;49817;50016;50276;193523;191930;190212;188588;123754;122766;121491;120388;69769;69164;68721;68200;51825;53535;55231;57117;
2062011;"Łomża (1)";62812;62711;62779;62737;11096;11142;11037;10918;42312;41653;41274;40775;25772;25319;25168;24952;16540;16334;16106;15823;9404;9916;10468;11044;
2063011;"Suwałki (1)";69404;69317;69316;69370;13692;13371;13165;13044;45911;45742;45467;45167;28469;28377;28238;28083;17442;17365;17229;17084;9801;10204;10684;11159;
2201012;"Borzytuchom (2)";3002;3058;3086;3115;702;699;707;710;1929;1974;1993;2015;1298;1341;1353;1375;631;633;640;640;371;385;386;390;
2201023;"Bytów (3)";24914;24830;25090;25198;5437;5327;5347;5351;16115;15939;15961;15854;10270;10221;10255;10185;5845;5718;5706;5669;3362;3564;3782;3993;
2201024;"Bytów - miasto (4)";17002;16842;17011;16971;3381;3292;3322;3308;11032;10799;10771;10585;6853;6767;6784;6662;4179;4032;3987;3923;2589;2751;2918;3078;
2201025;"Bytów - obszar wiejski (5)";7912;7988;8079;8227;2056;2035;2025;2043;5083;5140;5190;5269;3417;3454;3471;3523;1666;1686;1719;1746;773;813;864;915;
2201032;"Czarna Dąbrówka (2)";5799;5836;5833;5861;1377;1357;1346;1347;3682;3720;3701;3689;2332;2363;2356;2353;1350;1357;1345;1336;740;759;786;825;
2201042;"Kołczygłowy (2)";4264;4264;4272;4248;971;954;940;911;2770;2768;2765;2753;1776;1798;1807;1791;994;970;958;962;523;542;567;584;
2201052;"Lipnica (2)";5097;5123;5148;5139;1139;1106;1094;1066;3244;3281;3285;3270;2044;2077;2069;2065;1200;1204;1216;1205;714;736;769;803;
2201063;"Miastko (3)";20146;20077;20028;19950;3978;3900;3796;3691;13036;12883;12771;12641;7996;7944;7925;7862;5040;4939;4846;4779;3132;3294;3461;3618;
2201064;"Miastko - miasto (4)";11051;10926;10866;10785;1872;1839;1782;1732;7081;6879;6759;6622;4239;4159;4119;4045;2842;2720;2640;2577;2098;2208;2325;2431;
2201065;"Miastko - obszar wiejski (5)";9095;9151;9162;9165;2106;2061;2014;1959;5955;6004;6012;6019;3757;3785;3806;3817;2198;2219;2206;2202;1034;1086;1136;1187;
2201072;"Parchowo (2)";3640;3635;3663;3692;901;899;896;904;2288;2274;2269;2269;1479;1459;1472;1468;809;815;797;801;451;462;498;519;
2201082;"Studzienice (2)";3556;3583;3581;3639;769;774;779;799;2303;2294;2277;2277;1505;1488;1471;1468;798;806;806;809;484;515;525;563;
2201092;"Trzebielino (2)";3745;3733;3735;3721;792;772;767;750;2437;2436;2429;2405;1553;1546;1532;1513;884;890;897;892;516;525;539;566;
2201102;"Tuchomie (2)";4168;4168;4195;4217;1010;984;964;952;2721;2711;2715;2716;1774;1783;1795;1803;947;928;920;913;437;473;516;549;
2202011;"Chojnice (1)";40306;40226;40056;40043;7820;7729;7587;7553;25896;25633;25246;24933;16049;15984;15844;15769;9847;9649;9402;9164;6590;6864;7223;7557;
2202023;"Brusy (3)";14079;14146;14217;14323;3572;3503;3465;3451;8608;8682;8724;8808;5740;5781;5813;5834;2868;2901;2911;2974;1899;1961;2028;2064;
2202024;"Brusy - miasto (4)";4985;5037;5093;5149;1258;1257;1255;1250;3104;3124;3142;3175;2065;2078;2088;2094;1039;1046;1054;1081;623;656;696;724;
2202025;"Brusy - obszar wiejski (5)";9094;9109;9124;9174;2314;2246;2210;2201;5504;5558;5582;5633;3675;3703;3725;3740;1829;1855;1857;1893;1276;1305;1332;1340;
2202032;"Chojnice (2)";17845;18017;18210;18442;4366;4333;4307;4319;11237;11344;11443;11563;7367;7415;7485;7595;3870;3929;3958;3968;2242;2340;2460;2560;
2202043;"Czersk (3)";21491;21534;21583;21545;4742;4705;4641;4585;13558;13519;13524;13434;8549;8510;8531;8460;5009;5009;4993;4974;3191;3310;3418;3526;
2202044;"Czersk - miasto (4)";10045;10043;10030;10014;2108;2100;2046;2022;6397;6343;6322;6252;4058;4008;3995;3940;2339;2335;2327;2312;1540;1600;1662;1740;
2202045;"Czersk - obszar wiejski (5)";11446;11491;11553;11531;2634;2605;2595;2563;7161;7176;7202;7182;4491;4502;4536;4520;2670;2674;2666;2662;1651;1710;1756;1786;
2202052;"Konarzyny (2)";2273;2290;2279;2274;574;545;528;522;1393;1429;1430;1425;931;956;935;930;462;473;495;495;306;316;321;327;
2203011;"Człuchów (1)";14536;14385;14224;13976;2589;2568;2435;2323;9499;9256;9070;8786;5523;5358;5314;5198;3976;3898;3756;3588;2448;2561;2719;2867;
2203023;"Czarne (3)";9394;9316;9280;9293;1936;1877;1835;1787;6081;6003;5942;5943;3754;3700;3695;3717;2327;2303;2247;2226;1377;1436;1503;1563;
2203024;"Czarne - miasto (4)";6107;6089;6052;6091;1250;1228;1193;1180;3957;3914;3861;3874;2466;2429;2408;2434;1491;1485;1453;1440;900;947;998;1037;
2203025;"Czarne - obszar wiejski (5)";3287;3227;3228;3202;686;649;642;607;2124;2089;2081;2069;1288;1271;1287;1283;836;818;794;786;477;489;505;526;
2203032;"Człuchów (2)";10686;10718;10819;10938;2481;2426;2436;2396;6912;6972;7020;7095;4497;4562;4594;4661;2415;2410;2426;2434;1293;1320;1363;1447;
2203043;"Debrzno (3)";9301;9272;9210;9208;1976;1928;1897;1882;5911;5880;5801;5746;3639;3628;3575;3560;2272;2252;2226;2186;1414;1464;1512;1580;
2203044;"Debrzno - miasto (4)";5241;5232;5185;5184;1064;1050;1033;1031;3359;3310;3245;3200;2043;2018;1970;1953;1316;1292;1275;1247;818;872;907;953;
2203045;"Debrzno - obszar wiejski (5)";4060;4040;4025;4024;912;878;864;851;2552;2570;2556;2546;1596;1610;1605;1607;956;960;951;939;596;592;605;627;
2203052;"Koczała (2)";3488;3467;3415;3420;642;619;604;598;2319;2305;2259;2239;1318;1322;1299;1304;1001;983;960;935;527;543;552;583;
2203062;"Przechlewo (2)";6307;6323;6374;6359;1313;1285;1289;1279;4160;4155;4181;4134;2584;2606;2640;2628;1576;1549;1541;1506;834;883;904;946;
2203072;"Rzeczenica (2)";3690;3712;3706;3693;756;727;710;693;2433;2456;2446;2431;1502;1518;1519;1524;931;938;927;907;501;529;550;569;
2204011;"Pruszcz Gdański (1)";28621;28858;29226;29589;5885;5971;6070;6187;18394;18325;18413;18430;12487;12490;12547;12588;5907;5835;5866;5842;4342;4562;4743;4972;
2204022;"Cedry Wielkie (2)";6826;6848;6865;6868;1535;1519;1488;1454;4539;4542;4548;4533;2939;2934;2953;2961;1600;1608;1595;1572;752;787;829;881;
2204032;"Kolbudy (2)";15004;15307;15591;15908;3540;3596;3630;3663;9791;9913;10023;10158;6543;6595;6623;6729;3248;3318;3400;3429;1673;1798;1938;2087;
2204042;"Pruszcz Gdański (2)";23454;24734;25856;26976;5504;5823;6145;6458;15543;16295;16901;17443;10604;11256;11773;12207;4939;5039;5128;5236;2407;2616;2810;3075;
2204052;"Przywidz (2)";5697;5757;5805;5794;1353;1358;1321;1274;3627;3647;3674;3666;2321;2346;2373;2361;1306;1301;1301;1305;717;752;810;854;
2204062;"Pszczółki (2)";8731;8837;9005;9136;1913;1916;1923;1934;5818;5851;5926;5968;3743;3758;3801;3853;2075;2093;2125;2115;1000;1070;1156;1234;
2204072;"Suchy Dąb (2)";4142;4149;4159;4212;922;887;896;913;2765;2786;2769;2783;1836;1837;1839;1847;929;949;930;936;455;476;494;516;
2204082;"Trąbki Wielkie (2)";10692;10757;10875;10911;2545;2498;2468;2421;6934;6960;7046;7071;4547;4588;4644;4641;2387;2372;2402;2430;1213;1299;1361;1419;
2205012;"Chmielno (2)";7238;7261;7393;7426;1934;1907;1939;1910;4434;4453;4499;4511;2898;2910;2949;2981;1536;1543;1550;1530;870;901;955;1005;
2205023;"Kartuzy (3)";32878;33023;33275;33400;7678;7617;7583;7656;20451;20527;20613;20514;13211;13284;13381;13286;7240;7243;7232;7228;4749;4879;5079;5230;
2205024;"Kartuzy - miasto (4)";15007;14866;14840;14817;2934;2918;2895;2931;9315;9143;9029;8897;5804;5701;5656;5594;3511;3442;3373;3303;2758;2805;2916;2989;
2205025;"Kartuzy - obszar wiejski (5)";17871;18157;18435;18583;4744;4699;4688;4725;11136;11384;11584;11617;7407;7583;7725;7692;3729;3801;3859;3925;1991;2074;2163;2241;
2205032;"Przodkowo (2)";8165;8401;8669;8824;2211;2291;2378;2371;5025;5148;5293;5399;3425;3487;3576;3643;1600;1661;1717;1756;929;962;998;1054;
2205042;"Sierakowice (2)";18399;18581;18807;19106;5352;5342;5344;5431;11149;11256;11367;11505;7646;7690;7741;7837;3503;3566;3626;3668;1898;1983;2096;2170;
2205052;"Somonino (2)";9978;10093;10210;10304;2683;2661;2669;2651;6243;6343;6417;6505;4172;4231;4264;4309;2071;2112;2153;2196;1052;1089;1124;1148;
2205062;"Stężyca (2)";9835;9928;10039;10131;2833;2826;2822;2845;5889;5945;6004;6035;3981;4005;4050;4097;1908;1940;1954;1938;1113;1157;1213;1251;
2205072;"Sulęczyno (2)";5187;5247;5325;5386;1345;1360;1381;1389;3153;3160;3214;3232;2060;2066;2096;2098;1093;1094;1118;1134;689;727;730;765;
2205083;"Żukowo (3)";31414;32542;33380;34348;8076;8325;8469;8665;19967;20618;21123;21653;13231;13722;14037;14351;6736;6896;7086;7302;3371;3599;3788;4030;
2205084;"Żukowo - miasto (4)";6500;6521;6532;6552;1484;1476;1463;1436;4194;4190;4182;4170;2652;2651;2633;2610;1542;1539;1549;1560;822;855;887;946;
2205085;"Żukowo - obszar wiejski (5)";24914;26021;26848;27796;6592;6849;7006;7229;15773;16428;16941;17483;10579;11071;11404;11741;5194;5357;5537;5742;2549;2744;2901;3084;
2206011;"Kościerzyna (1)";23779;23701;23738;23744;4946;4897;4881;4845;14946;14738;14640;14532;9476;9372;9350;9302;5470;5366;5290;5230;3887;4066;4217;4367;
2206022;"Dziemiany (2)";4243;4268;4268;4284;979;973;976;982;2742;2749;2722;2712;1777;1790;1759;1761;965;959;963;951;522;546;570;590;
2206032;"Karsin (2)";6205;6237;6249;6255;1499;1461;1454;1427;3775;3796;3782;3801;2385;2424;2394;2417;1390;1372;1388;1384;931;980;1013;1027;
2206042;"Kościerzyna (2)";15209;15357;15466;15550;3822;3803;3780;3728;9654;9790;9835;9884;6344;6417;6418;6457;3310;3373;3417;3427;1733;1764;1851;1938;
2206052;"Liniewo (2)";4634;4652;4663;4642;1016;1022;1014;1006;2943;2935;2923;2874;1837;1831;1835;1815;1106;1104;1088;1059;675;695;726;762;
2206062;"Lipusz (2)";3603;3613;3639;3660;885;879;875;877;2272;2278;2293;2299;1509;1495;1512;1499;763;783;781;800;446;456;471;484;
2206072;"Nowa Karczma (2)";6720;6766;6758;6825;1781;1765;1726;1746;4074;4120;4119;4123;2687;2713;2707;2710;1387;1407;1412;1413;865;881;913;956;
2206082;"Stara Kiszewa (2)";6648;6647;6613;6664;1531;1505;1493;1495;4216;4217;4179;4183;2716;2719;2681;2672;1500;1498;1498;1511;901;925;941;986;
2207011;"Kwidzyn (1)";38931;38867;38757;38650;7883;7768;7680;7648;25269;24977;24593;24226;15986;15876;15725;15513;9283;9101;8868;8713;5779;6122;6484;6776;
2207022;"Gardeja (2)";8482;8460;8457;8458;2062;2029;1980;1944;5356;5300;5296;5295;3490;3479;3514;3538;1866;1821;1782;1757;1064;1131;1181;1219;
2207032;"Kwidzyn (2)";11119;11138;11222;11241;2477;2432;2427;2412;7420;7463;7496;7472;4810;4806;4826;4807;2610;2657;2670;2665;1222;1243;1299;1357;
2207043;"Prabuty (3)";13373;13278;13235;13230;2870;2790;2736;2681;8616;8534;8467;8429;5404;5356;5332;5326;3212;3178;3135;3103;1887;1954;2032;2120;
2207044;"Prabuty - miasto (4)";8855;8802;8781;8761;1759;1732;1715;1685;5792;5709;5639;5581;3573;3537;3518;3494;2219;2172;2121;2087;1304;1361;1427;1495;
2207045;"Prabuty - obszar wiejski (5)";4518;4476;4454;4469;1111;1058;1021;996;2824;2825;2828;2848;1831;1819;1814;1832;993;1006;1014;1016;583;593;605;625;
2207052;"Ryjewo (2)";5985;5972;6050;5986;1259;1237;1223;1196;3939;3925;3925;3859;2460;2427;2409;2397;1479;1498;1516;1462;787;810;902;931;
2207062;"Sadlinki (2)";5893;5896;5906;5899;1371;1340;1304;1274;3913;3910;3931;3911;2558;2581;2604;2596;1355;1329;1327;1315;609;646;671;714;
2208011;"Lębork (1)";35588;35526;35443;35388;6731;6572;6473;6377;22918;22704;22441;22219;14057;14027;13933;13831;8861;8677;8508;8388;5939;6250;6529;6792;
2208021;"Łeba (1)";3864;3824;3836;3789;632;610;594;576;2550;2481;2469;2408;1436;1402;1419;1402;1114;1079;1050;1006;682;733;773;805;
2208032;"Cewice (2)";7352;7356;7481;7531;1836;1826;1870;1879;4730;4690;4711;4707;3106;3092;3132;3134;1624;1598;1579;1573;786;840;900;945;
2208042;"Nowa Wieś Lęborska (2)";13369;13378;13455;13511;3113;3057;3015;2967;8665;8651;8661;8678;5532;5515;5569;5557;3133;3136;3092;3121;1591;1670;1779;1866;
2208052;"Wicko (2)";6013;6046;6041;5968;1393;1389;1383;1322;3864;3861;3821;3767;2498;2514;2481;2431;1366;1347;1340;1336;756;796;837;879;
2209011;"Malbork (1)";39252;39022;38950;38931;7016;6886;6810;6794;25315;24949;24643;24312;15319;15217;15058;14951;9996;9732;9585;9361;6921;7187;7497;7825;
2209032;"Lichnowy (2)";4801;4782;4725;4731;1140;1102;1063;1053;3092;3111;3085;3078;2001;1997;1979;1977;1091;1114;1106;1101;569;569;577;600;
2209042;"Malbork (2)";4620;4651;4687;4728;1034;1031;1043;1024;3039;3044;3063;3087;1948;1939;1954;1971;1091;1105;1109;1116;547;576;581;617;
2209062;"Miłoradz (2)";3365;3376;3415;3396;700;696;695;686;2210;2224;2247;2234;1357;1369;1389;1392;853;855;858;842;455;456;473;476;
2209073;"Nowy Staw (3)";7926;7821;7783;7807;1628;1570;1562;1526;5119;5058;4978;4951;3173;3159;3084;3036;1946;1899;1894;1915;1179;1193;1243;1330;
2209074;"Nowy Staw - miasto (4)";4412;4335;4330;4377;864;839;838;807;2823;2765;2730;2739;1712;1708;1678;1640;1111;1057;1052;1099;725;731;762;831;
2209075;"Nowy Staw - obszar wiejski (5)";3514;3486;3453;3430;764;731;724;719;2296;2293;2248;2212;1461;1451;1406;1396;835;842;842;816;454;462;481;499;
2209082;"Stare Pole (2)";4733;4719;4697;4718;1041;1019;984;970;3111;3101;3081;3083;1934;1911;1887;1904;1177;1190;1194;1179;581;599;632;665;
2210011;"Krynica Morska (1)";1349;1351;1335;1323;239;241;221;206;881;871;864;864;512;516;512;499;369;355;352;365;229;239;250;253;
2210023;"Nowy Dwór Gdański (3)";18252;18169;18084;18079;3734;3612;3535;3478;11915;11828;11685;11642;7396;7394;7372;7367;4519;4434;4313;4275;2603;2729;2864;2959;
2210024;"Nowy Dwór Gdański - miasto (4)";10171;10083;10015;10022;1964;1864;1811;1798;6615;6517;6401;6345;4066;4070;4024;3994;2549;2447;2377;2351;1592;1702;1803;1879;
2210025;"Nowy Dwór Gdański - obszar wiejski (5)";8081;8086;8069;8057;1770;1748;1724;1680;5300;5311;5284;5297;3330;3324;3348;3373;1970;1987;1936;1924;1011;1027;1061;1080;
2210032;"Ostaszewo (2)";3243;3213;3209;3223;655;623;607;611;2130;2109;2117;2108;1321;1311;1305;1283;809;798;812;825;458;481;485;504;
2210042;"Stegna (2)";9946;9949;9949;9844;1982;1960;1908;1864;6459;6413;6378;6293;3914;3902;3919;3875;2545;2511;2459;2418;1505;1576;1663;1687;
2210052;"Sztutowo (2)";3669;3650;3677;3685;739;706;716;690;2367;2359;2354;2353;1435;1454;1471;1492;932;905;883;861;563;585;607;642;
2211011;"Hel (1)";3737;3668;3594;3531;702;662;621;592;2462;2402;2334;2279;1536;1490;1431;1384;926;912;903;895;573;604;639;660;
2211021;"Jastarnia (1)";3905;3874;3866;3824;756;727;722;706;2508;2474;2444;2378;1512;1480;1461;1429;996;994;983;949;641;673;700;740;
2211031;"Puck (1)";11520;11396;11321;11329;2215;2154;2084;2096;7075;6955;6864;6782;4343;4271;4211;4154;2732;2684;2653;2628;2230;2287;2373;2451;
2211041;"Władysławowo (1)";15382;15400;15456;;3157;3123;3096;;10044;9958;9911;;6218;6178;6186;;3826;3780;3725;;2181;2319;2449;;
2211043;"Władysławowo (3)";;;;15467;;;;3065;;;;9837;;;;6139;;;;3698;;;;2565;
2211044;"Władysławowo - miasto (4)";;;;10051;;;;1999;;;;6397;;;;3998;;;;2399;;;;1655;
2211045;"Władysławowo - obszar wiejski (5)";;;;5416;;;;1066;;;;3440;;;;2141;;;;1299;;;;910;
2211052;"Kosakowo (2)";11023;11751;12342;12813;2537;2710;2849;2952;7322;7749;8099;8351;4773;5113;5393;5613;2549;2636;2706;2738;1164;1292;1394;1510;
2211062;"Krokowa (2)";10596;10658;10652;10673;2621;2606;2565;2539;6713;6751;6742;6716;4333;4364;4349;4350;2380;2387;2393;2366;1262;1301;1345;1418;
2211072;"Puck (2)";24575;24850;25183;25443;6212;6220;6256;6205;15627;15763;15912;16081;10299;10351;10482;10611;5328;5412;5430;5470;2736;2867;3015;3157;
2212011;"Ustka (1)";16379;16263;16056;15933;2603;2554;2468;2405;10498;10212;9957;9686;6146;6032;5937;5872;4352;4180;4020;3814;3278;3497;3631;3842;
2212022;"Damnica (2)";6295;6311;6281;6258;1417;1382;1343;1307;4119;4134;4112;4095;2547;2560;2543;2537;1572;1574;1569;1558;759;795;826;856;
2212032;"Dębnica Kaszubska (2)";9810;9803;9802;9795;2176;2128;2090;2053;6346;6324;6285;6282;4063;4064;4061;4046;2283;2260;2224;2236;1288;1351;1427;1460;
2212042;"Główczyce (2)";9552;9475;9436;9371;2151;2083;2074;2025;6206;6167;6082;6031;3911;3910;3858;3877;2295;2257;2224;2154;1195;1225;1280;1315;
2212053;"Kępice (3)";9510;9445;9449;9406;1879;1911;1833;1753;6243;6102;6126;6107;3889;3766;3825;3842;2354;2336;2301;2265;1388;1432;1490;1546;
2212054;"Kępice - miasto (4)";3818;3802;3737;3711;674;653;622;606;2510;2487;2422;2377;1522;1526;1487;1463;988;961;935;914;634;662;693;728;
2212055;"Kępice - obszar wiejski (5)";5692;5643;5712;5695;1205;1258;1211;1147;3733;3615;3704;3730;2367;2240;2338;2379;1366;1375;1366;1351;754;770;797;818;
2212062;"Kobylnica (2)";10965;11076;11302;11491;2252;2259;2327;2368;7356;7393;7449;7522;4622;4642;4695;4802;2734;2751;2754;2720;1357;1424;1526;1601;
2212072;"Potęgowo (2)";7168;7128;7091;7064;1562;1537;1512;1510;4695;4640;4620;4547;3038;2991;2989;2934;1657;1649;1631;1613;911;951;959;1007;
2212082;"Słupsk (2)";16065;16317;16558;17049;3470;3528;3513;3542;10783;10836;10972;11269;6820;6867;6976;7185;3963;3969;3996;4084;1812;1953;2073;2238;
2212092;"Smołdzino (2)";3547;3507;3475;3431;668;651;636;620;2380;2327;2290;2244;1466;1430;1415;1374;914;897;875;870;499;529;549;567;
2212102;"Ustka (2)";8076;8112;8277;8342;1673;1652;1673;1643;5339;5323;5414;5475;3243;3223;3320;3353;2096;2100;2094;2122;1064;1137;1190;1224;
2213011;"Czarna Woda (1)";3303;3284;;;642;613;;;2108;2098;;;1242;1224;;;866;874;;;553;573;;;
2213013;"Czarna Woda (3)";;;3270;3264;;;591;577;;;2095;2062;;;1225;1213;;;870;849;;;584;625;
2213014;"Czarna Woda - miasto (4)";;;2865;2873;;;509;505;;;1825;1798;;;1065;1055;;;760;743;;;531;570;
2213015;"Czarna Woda - obszar wiejski (5)";;;405;391;;;82;72;;;270;264;;;160;158;;;110;106;;;53;55;
2213021;"Skórcz (1)";3605;3599;3551;3536;805;787;746;751;2338;2337;2303;2274;1477;1492;1460;1443;861;845;843;831;462;475;502;511;
2213031;"Starogard Gdański (1)";48808;48621;48327;48309;9621;9497;9371;9350;30897;30449;29949;29593;19434;19246;19059;18929;11463;11203;10890;10664;8290;8675;9007;9366;
2213042;"Bobowo (2)";3033;3069;3066;3112;747;737;730;736;1928;1954;1942;1967;1256;1285;1278;1312;672;669;664;655;358;378;394;409;
2213052;"Kaliska (2)";5283;5279;5277;5294;1169;1151;1120;1102;3393;3399;3400;3407;2161;2143;2125;2133;1232;1256;1275;1274;721;729;757;785;
2213062;"Lubichowo (2)";6221;6299;6343;6408;1449;1448;1430;1441;3929;3976;4008;4040;2499;2535;2564;2583;1430;1441;1444;1457;843;875;905;927;
2213072;"Osieczna (2)";2934;2907;2878;2868;669;642;616;600;1847;1840;1826;1823;1183;1180;1150;1140;664;660;676;683;418;425;436;445;
2213082;"Osiek (2)";2475;2483;2502;2457;445;436;446;418;1585;1590;1576;1548;951;958;948;940;634;632;628;608;445;457;480;491;
2213093;"Skarszewy (3)";14658;14677;14712;14720;3443;3423;3463;3439;9436;9422;9367;9339;6163;6148;6068;6064;3273;3274;3299;3275;1779;1832;1882;1942;
2213094;"Skarszewy - miasto (4)";7105;7082;7057;7111;1545;1504;1503;1551;4687;4680;4625;4592;3008;3016;2928;2916;1679;1664;1697;1676;873;898;929;968;
2213095;"Skarszewy - obszar wiejski (5)";7553;7595;7655;7609;1898;1919;1960;1888;4749;4742;4742;4747;3155;3132;3140;3148;1594;1610;1602;1599;906;934;953;974;
2213102;"Skórcz (2)";4659;4641;4666;4618;1074;1047;1052;1015;2983;2965;2954;2940;1949;1944;1941;1920;1034;1021;1013;1020;602;629;660;663;
2213112;"Smętowo Graniczne (2)";5354;5327;5309;5262;1171;1148;1102;1078;3440;3410;3401;3355;2163;2152;2154;2130;1277;1258;1247;1225;743;769;806;829;
2213122;"Starogard Gdański (2)";15338;15627;15898;15934;3669;3670;3661;3549;10138;10352;10527;10551;6644;6794;6881;6905;3494;3558;3646;3646;1531;1605;1710;1834;
2213132;"Zblewo (2)";11426;11466;11498;11507;2654;2678;2630;2576;7417;7407;7428;7437;4828;4799;4813;4834;2589;2608;2615;2603;1355;1381;1440;1494;
2214011;"Tczew (1)";60769;60610;60573;60052;11718;11596;11599;11333;38609;38147;37616;36950;24480;24299;24091;23778;14129;13848;13525;13172;10442;10867;11358;11769;
2214023;"Gniew (3)";16006;15875;15875;15760;3361;3226;3201;3138;10236;10177;10103;9982;6432;6374;6314;6212;3804;3803;3789;3770;2409;2472;2571;2640;
2214024;"Gniew - miasto (4)";6915;6868;6898;6869;1295;1249;1263;1265;4377;4335;4294;4207;2674;2648;2623;2583;1703;1687;1671;1624;1243;1284;1341;1397;
2214025;"Gniew - obszar wiejski (5)";9091;9007;8977;8891;2066;1977;1938;1873;5859;5842;5809;5775;3758;3726;3691;3629;2101;2116;2118;2146;1166;1188;1230;1243;
2214032;"Morzeszczyn (2)";3778;3807;3781;3743;913;931;911;894;2446;2442;2407;2382;1557;1541;1528;1500;889;901;879;882;419;434;463;467;
2214043;"Pelplin (3)";16718;16675;16647;16564;3620;3564;3501;3399;10804;10730;10697;10590;6910;6862;6826;6772;3894;3868;3871;3818;2294;2381;2449;2575;
2214044;"Pelplin - miasto (4)";8237;8254;8225;8123;1596;1596;1570;1516;5289;5253;5209;5110;3331;3329;3283;3209;1958;1924;1926;1901;1352;1405;1446;1497;
2214045;"Pelplin - obszar wiejski (5)";8481;8421;8422;8441;2024;1968;1931;1883;5515;5477;5488;5480;3579;3533;3543;3563;1936;1944;1945;1917;942;976;1003;1078;
2214052;"Subkowy (2)";5466;5487;5483;5538;1323;1287;1278;1259;3524;3564;3539;3574;2308;2310;2264;2281;1216;1254;1275;1293;619;636;666;705;
2214062;"Tczew (2)";13238;13508;13681;13953;3112;3180;3225;3257;8680;8827;8887;9027;5697;5778;5837;5950;2983;3049;3050;3077;1446;1501;1569;1669;
2215011;"Reda (1)";22479;23135;23565;24029;4879;5071;5150;5258;15401;15663;15784;15899;10113;10374;10561;10708;5288;5289;5223;5191;2199;2401;2631;2872;
2215021;"Rumia (1)";47304;47374;47602;47812;8959;8911;8994;9075;31050;30701;30402;30075;19552;19417;19275;19135;11498;11284;11127;10940;7295;7762;8206;8662;
2215031;"Wejherowo (1)";50375;50340;50292;50215;10481;10431;10417;10368;31666;31345;31044;30665;20836;20708;20581;20332;10830;10637;10463;10333;8228;8564;8831;9182;
2215042;"Choczewo (2)";5685;5647;5635;5630;1248;1225;1209;1197;3676;3633;3604;3587;2288;2246;2240;2247;1388;1387;1364;1340;761;789;822;846;
2215052;"Gniewino (2)";7268;7329;7384;7425;1846;1814;1820;1796;4682;4730;4730;4757;2943;2985;2998;3019;1739;1745;1732;1738;740;785;834;872;
2215062;"Linia (2)";6053;6111;6147;6213;1626;1638;1641;1625;3712;3715;3747;3813;2526;2529;2529;2571;1186;1186;1218;1242;715;758;759;775;
2215072;"Luzino (2)";14678;14953;15137;15337;4134;4158;4137;4105;9142;9315;9460;9635;6248;6348;6418;6506;2894;2967;3042;3129;1402;1480;1540;1597;
2215082;"Łęczyce (2)";11831;11888;11935;11977;3033;3013;2988;2990;7499;7480;7450;7424;4970;4987;4981;4988;2529;2493;2469;2436;1299;1395;1497;1563;
2215092;"Szemud (2)";15718;16076;16406;16702;4245;4330;4408;4440;9838;10032;10177;10353;6598;6662;6749;6861;3240;3370;3428;3492;1635;1714;1821;1909;
2215102;"Wejherowo (2)";22471;23039;23573;24067;5947;5988;6081;6197;14287;14666;14999;15251;9733;9951;10138;10270;4554;4715;4861;4981;2237;2385;2493;2619;
2216013;"Dzierzgoń (3)";9590;9508;9465;9430;2045;1977;1922;1909;6256;6180;6136;6065;3958;3897;3877;3835;2298;2283;2259;2230;1289;1351;1407;1456;
2216014;"Dzierzgoń - miasto (4)";5640;5593;5524;5502;1133;1102;1050;1035;3717;3659;3605;3554;2312;2275;2246;2230;1405;1384;1359;1324;790;832;869;913;
2216015;"Dzierzgoń - obszar wiejski (5)";3950;3915;3941;3928;912;875;872;874;2539;2521;2531;2511;1646;1622;1631;1605;893;899;900;906;499;519;538;543;
2216022;"Mikołajki Pomorskie (2)";3740;3760;3739;3729;848;863;844;823;2443;2432;2398;2392;1550;1544;1525;1524;893;888;873;868;449;465;497;514;
2216032;"Stary Dzierzgoń (2)";4164;4105;4088;4077;918;874;847;826;2685;2665;2648;2632;1638;1626;1612;1617;1047;1039;1036;1015;561;566;593;619;
2216042;"Stary Targ (2)";6429;6435;6425;6414;1403;1396;1356;1345;4237;4221;4197;4143;2757;2735;2724;2673;1480;1486;1473;1470;789;818;872;926;
2216053;"Sztum (3)";18735;18703;18765;18727;3710;3683;3645;3597;12436;12295;12196;12032;7648;7639;7617;7564;4788;4656;4579;4468;2589;2725;2924;3098;
2216054;"Sztum - miasto (4)";10377;10332;10308;10299;1783;1779;1738;1751;6899;6759;6664;6546;4146;4147;4106;4070;2753;2612;2558;2476;1695;1794;1906;2002;
2216055;"Sztum - obszar wiejski (5)";8358;8371;8457;8428;1927;1904;1907;1846;5537;5536;5532;5486;3502;3492;3511;3494;2035;2044;2021;1992;894;931;1018;1096;
2261011;"Gdańsk (1)";460427;461531;461489;462249;73435;73911;74542;75649;291824;289430;285517;281839;185215;185306;183973;182657;106609;104124;101544;99182;95168;98190;101430;104761;
2262011;"Gdynia (1)";248726;248042;247820;247478;39764;39508;39622;39720;155787;153492;151306;149112;96452;95734;95075;93994;59335;57758;56231;55118;53175;55042;56892;58646;
2263011;"Słupsk (1)";94849;93936;93206;92496;15253;14974;14776;14694;60996;59565;58285;56897;36667;35964;35384;34716;24329;23601;22901;22181;18600;19397;20145;20905;
2264011;"Sopot (1)";38217;37903;37654;37231;4630;4548;4535;4510;23349;22919;22500;21904;14114;13941;13794;13465;9235;8978;8706;8439;10238;10436;10619;10817;
2401011;"Będzin (1)";58735;58425;58205;57900;9218;9192;9154;9155;37499;36827;36196;35471;22555;22407;22226;21958;14944;14420;13970;13513;12018;12406;12855;13274;
2401021;"Czeladź (1)";33345;32940;32666;32395;5002;4898;4844;4811;21291;20806;20381;19919;12359;12158;11973;11729;8932;8648;8408;8190;7052;7236;7441;7665;
2401031;"Wojkowice (1)";9172;9107;9033;9055;1345;1345;1308;1317;5920;5828;5742;5722;3381;3302;3292;3286;2539;2526;2450;2436;1907;1934;1983;2016;
2401042;"Bobrowniki (2)";11800;11912;11941;11881;1907;1934;1928;1941;7348;7339;7291;7189;4369;4410;4380;4308;2979;2929;2911;2881;2545;2639;2722;2751;
2401052;"Mierzęcice (2)";7563;7588;7614;7603;1287;1281;1269;1273;4826;4822;4827;4780;2993;2979;2994;2950;1833;1843;1833;1830;1450;1485;1518;1550;
2401062;"Psary (2)";11701;11817;11859;11877;1907;1990;1998;1960;7306;7281;7255;7231;4319;4323;4309;4315;2987;2958;2946;2916;2488;2546;2606;2686;
2401073;"Siewierz (3)";12234;12252;12284;12287;2045;2071;2070;2072;7902;7808;7739;7609;4737;4709;4695;4660;3165;3099;3044;2949;2287;2373;2475;2606;
2401074;"Siewierz - miasto (4)";5478;5481;5495;5495;887;887;896;904;3526;3478;3430;3365;2074;2068;2044;2027;1452;1410;1386;1338;1065;1116;1169;1226;
2401075;"Siewierz - obszar wiejski (5)";6756;6771;6789;6792;1158;1184;1174;1168;4376;4330;4309;4244;2663;2641;2651;2633;1713;1689;1658;1611;1222;1257;1306;1380;
2401081;"Sławków (1)";7100;7129;7135;7105;1228;1235;1231;1219;4536;4511;4458;4375;2744;2754;2740;2712;1792;1757;1718;1663;1336;1383;1446;1511;
2402011;"Szczyrk (1)";5760;5750;5799;5715;983;982;1010;958;3722;3686;3694;3643;2281;2267;2278;2245;1441;1419;1416;1398;1055;1082;1095;1114;
2402022;"Bestwina (2)";11067;11187;11309;11405;2125;2141;2170;2173;7130;7169;7205;7223;4465;4480;4491;4508;2665;2689;2714;2715;1812;1877;1934;2009;
2402032;"Buczkowice (2)";11021;11096;11119;11124;2129;2124;2126;2105;7020;7031;7000;7002;4467;4507;4491;4499;2553;2524;2509;2503;1872;1941;1993;2017;
2402043;"Czechowice-Dziedzice (3)";44554;44779;44805;44970;8530;8507;8448;8466;28559;28457;28204;28062;17749;17867;17751;17745;10810;10590;10453;10317;7465;7815;8153;8442;
2402044;"Czechowice-Dziedzice - miasto (4)";35543;35684;35632;35725;6630;6613;6544;6547;22782;22653;22372;22227;14099;14162;14064;14058;8683;8491;8308;8169;6131;6418;6716;6951;
2402045;"Czechowice-Dziedzice - obszar wiejski (5)";9011;9095;9173;9245;1900;1894;1904;1919;5777;5804;5832;5835;3650;3705;3687;3687;2127;2099;2145;2148;1334;1397;1437;1491;
2402052;"Jasienica (2)";22602;22870;23121;23344;4781;4840;4881;4957;14487;14573;14654;14675;9330;9408;9482;9444;5157;5165;5172;5231;3334;3457;3586;3712;
2402062;"Jaworze (2)";6883;6980;7051;7146;1298;1296;1300;1312;4353;4385;4369;4397;2656;2688;2694;2718;1697;1697;1675;1679;1232;1299;1382;1437;
2402072;"Kozy (2)";12429;12529;12660;12724;2349;2351;2402;2432;7997;8013;8012;7986;5007;5023;4991;4963;2990;2990;3021;3023;2083;2165;2246;2306;
2402082;"Porąbka (2)";15359;15399;15384;15408;3032;3000;2934;2922;9757;9753;9696;9663;6121;6122;6093;6041;3636;3631;3603;3622;2570;2646;2754;2823;
2402093;"Wilamowice (3)";16474;16670;16821;16951;3389;3393;3391;3415;10466;10608;10687;10741;6735;6815;6867;6887;3731;3793;3820;3854;2619;2669;2743;2795;
2402094;"Wilamowice - miasto (4)";3011;3015;3033;3038;594;591;598;601;1878;1890;1902;1893;1195;1191;1192;1178;683;699;710;715;539;534;533;544;
2402095;"Wilamowice - obszar wiejski (5)";13463;13655;13788;13913;2795;2802;2793;2814;8588;8718;8785;8848;5540;5624;5675;5709;3048;3094;3110;3139;2080;2135;2210;2251;
2402102;"Wilkowice (2)";13092;13145;13290;13341;2332;2265;2279;2268;8314;8339;8377;8358;5079;5100;5119;5095;3235;3239;3258;3263;2446;2541;2634;2715;
2403011;"Cieszyn (1)";36119;35918;35685;35274;5943;5905;5873;5836;22815;22365;21878;21373;13857;13599;13338;13026;8958;8766;8540;8347;7361;7648;7934;8065;
2403021;"Ustroń (1)";16002;16003;16073;16013;2620;2613;2615;2568;9866;9757;9669;9498;5933;5883;5881;5772;3933;3874;3788;3726;3516;3633;3789;3947;
2403031;"Wisła (1)";11333;11261;11198;11090;1975;1996;1956;1914;7126;6993;6911;6778;4340;4239;4179;4110;2786;2754;2732;2668;2232;2272;2331;2398;
2403042;"Brenna (2)";10923;10978;11064;11105;2302;2252;2253;2260;6818;6837;6869;6840;4277;4273;4279;4275;2541;2564;2590;2565;1803;1889;1942;2005;
2403052;"Chybie (2)";9488;9543;9579;9648;1983;1985;2000;2010;6080;6099;6059;6041;3775;3794;3770;3776;2305;2305;2289;2265;1425;1459;1520;1597;
2403062;"Dębowiec (2)";5665;5700;5751;5777;1164;1151;1168;1160;3648;3659;3685;3688;2317;2319;2317;2314;1331;1340;1368;1374;853;890;898;929;
2403072;"Goleszów (2)";12753;12908;12987;13058;2370;2379;2368;2372;8047;8117;8104;8071;4931;5001;5000;5012;3116;3116;3104;3059;2336;2412;2515;2615;
2403082;"Hażlach (2)";10543;10608;10629;10658;2258;2232;2229;2178;6875;6880;6852;6863;4322;4336;4276;4298;2553;2544;2576;2565;1410;1496;1548;1617;
2403092;"Istebna (2)";11854;11908;11935;11964;2822;2821;2794;2799;7505;7515;7538;7511;4808;4783;4770;4754;2697;2732;2768;2757;1527;1572;1603;1654;
2403103;"Skoczów (3)";26696;26727;26697;26770;5180;5149;5107;5116;16898;16807;16654;16468;10644;10634;10582;10493;6254;6173;6072;5975;4618;4771;4936;5186;
2403104;"Skoczów - miasto (4)";14868;14741;14625;14575;2667;2603;2541;2539;9386;9213;9039;8844;5833;5760;5729;5638;3553;3453;3310;3206;2815;2925;3045;3192;
2403105;"Skoczów - obszar wiejski (5)";11828;11986;12072;12195;2513;2546;2566;2577;7512;7594;7615;7624;4811;4874;4853;4855;2701;2720;2762;2769;1803;1846;1891;1994;
2403113;"Strumień (3)";12659;12781;12940;12987;2615;2632;2657;2630;8196;8244;8268;8251;5114;5161;5170;5184;3082;3083;3098;3067;1848;1905;2015;2106;
2403114;"Strumień - miasto (4)";3607;3642;3642;3649;785;787;785;778;2352;2365;2336;2311;1452;1461;1441;1432;900;904;895;879;470;490;521;560;
2403115;"Strumień - obszar wiejski (5)";9052;9139;9298;9338;1830;1845;1872;1852;5844;5879;5932;5940;3662;3700;3729;3752;2182;2179;2203;2188;1378;1415;1494;1546;
2403122;"Zebrzydowice (2)";13089;13144;13170;13218;2709;2673;2655;2655;8154;8144;8093;8065;5143;5168;5136;5091;3011;2976;2957;2974;2226;2327;2422;2498;
2404013;"Blachownia (3)";13233;13223;13214;13152;2225;2186;2157;2109;8430;8367;8295;8205;4990;4970;4947;4900;3440;3397;3348;3305;2578;2670;2762;2838;
2404014;"Blachownia - miasto (4)";9863;9839;9830;9777;1594;1551;1530;1502;6239;6184;6129;6032;3620;3622;3611;3576;2619;2562;2518;2456;2030;2104;2171;2243;
2404015;"Blachownia - obszar wiejski (5)";3370;3384;3384;3375;631;635;627;607;2191;2183;2166;2173;1370;1348;1336;1324;821;835;830;849;548;566;591;595;
2404022;"Dąbrowa Zielona (2)";4026;4007;3972;3919;628;627;604;583;2474;2451;2432;2400;1436;1431;1418;1396;1038;1020;1014;1004;924;929;936;936;
2404032;"Janów (2)";5998;5993;5991;5971;1103;1085;1072;1049;3836;3828;3809;3799;2377;2372;2360;2346;1459;1456;1449;1453;1059;1080;1110;1123;
2404042;"Kamienica Polska (2)";5602;5646;5652;5631;925;923;920;929;3560;3580;3560;3496;2157;2169;2161;2110;1403;1411;1399;1386;1117;1143;1172;1206;
2404052;"Kłomnice (2)";13771;13774;13705;13676;2394;2320;2244;2208;8724;8756;8705;8647;5415;5447;5379;5333;3309;3309;3326;3314;2653;2698;2756;2821;
2404063;"Koniecpol (3)";9998;9897;9836;9740;1671;1600;1543;1496;6267;6204;6187;6099;3821;3770;3747;3707;2446;2434;2440;2392;2060;2093;2106;2145;
2404064;"Koniecpol - miasto (4)";6233;6165;6142;6094;1039;994;957;935;3943;3881;3885;3821;2384;2335;2322;2292;1559;1546;1563;1529;1251;1290;1300;1338;
2404065;"Koniecpol - obszar wiejski (5)";3765;3732;3694;3646;632;606;586;561;2324;2323;2302;2278;1437;1435;1425;1415;887;888;877;863;809;803;806;807;
2404072;"Konopiska (2)";10714;10692;10750;10740;1859;1824;1815;1809;6943;6917;6947;6875;4250;4215;4239;4194;2693;2702;2708;2681;1912;1951;1988;2056;
2404082;"Kruszyna (2)";4915;4887;4910;4890;934;912;902;878;3177;3154;3168;3157;2010;2001;1988;1973;1167;1153;1180;1184;804;821;840;855;
2404092;"Lelów (2)";5012;4988;4965;4928;813;803;793;769;3109;3100;3072;3061;1868;1856;1827;1810;1241;1244;1245;1251;1090;1085;1100;1098;
2404102;"Mstów (2)";10635;10725;10724;10759;2072;2056;1995;1959;6830;6885;6892;6903;4294;4358;4369;4366;2536;2527;2523;2537;1733;1784;1837;1897;
2404112;"Mykanów (2)";14692;14805;14860;14947;2919;2909;2863;2815;9496;9559;9564;9586;6046;6054;6061;6063;3450;3505;3503;3523;2277;2337;2433;2546;
2404122;"Olsztyn (2)";7257;7283;7649;7736;1450;1437;1480;1469;4642;4645;4828;4874;2891;2895;3014;3044;1751;1750;1814;1830;1165;1201;1341;1393;
2404132;"Poczesna (2)";12782;12808;12782;12808;2197;2181;2144;2127;8362;8339;8302;8249;5088;5095;5046;5054;3274;3244;3256;3195;2223;2288;2336;2432;
2404142;"Przyrów (2)";3906;3878;3869;3862;618;595;596;596;2458;2466;2468;2449;1499;1506;1508;1504;959;960;960;945;830;817;805;817;
2404152;"Rędziny (2)";10046;10105;10055;10054;1754;1749;1703;1686;6494;6475;6457;6435;3942;3911;3903;3904;2552;2564;2554;2531;1798;1881;1895;1933;
2404162;"Starcza (2)";2817;2838;2826;2820;531;529;534;532;1780;1794;1762;1752;1081;1109;1089;1082;699;685;673;670;506;515;530;536;
2405011;"Knurów (1)";39320;39090;38859;38741;7193;7130;7069;7063;25483;25084;24684;24308;15836;15636;15457;15306;9647;9448;9227;9002;6644;6876;7106;7370;
2405021;"Pyskowice (1)";18704;18642;18563;18452;2916;2878;2860;2831;12323;12226;12074;11901;7448;7351;7283;7147;4875;4875;4791;4754;3465;3538;3629;3720;
2405032;"Gierałtowice (2)";11328;11510;11624;11758;2130;2187;2253;2291;7155;7232;7211;7228;4458;4532;4525;4527;2697;2700;2686;2701;2043;2091;2160;2239;
2405042;"Pilchowice (2)";11250;11396;11451;11554;2064;2105;2137;2175;7301;7363;7337;7343;4482;4480;4464;4467;2819;2883;2873;2876;1885;1928;1977;2036;
2405052;"Rudziniec (2)";10590;10575;10613;10652;1804;1766;1767;1787;6869;6839;6844;6823;4187;4124;4086;4048;2682;2715;2758;2775;1917;1970;2002;2042;
2405063;"Sośnicowice (3)";8659;8641;8682;8674;1489;1497;1499;1487;5684;5612;5601;5551;3387;3347;3328;3292;2297;2265;2273;2259;1486;1532;1582;1636;
2405064;"Sośnicowice - miasto (4)";1854;1853;1854;1843;267;268;269;270;1252;1234;1221;1194;757;745;731;706;495;489;490;488;335;351;364;379;
2405065;"Sośnicowice - obszar wiejski (5)";6805;6788;6828;6831;1222;1229;1230;1217;4432;4378;4380;4357;2630;2602;2597;2586;1802;1776;1783;1771;1151;1181;1218;1257;
2405073;"Toszek (3)";9526;9494;9433;9429;1673;1638;1626;1620;6189;6154;6086;6075;3781;3751;3677;3666;2408;2403;2409;2409;1664;1702;1721;1734;
2405074;"Toszek - miasto (4)";3695;3664;3615;3604;682;645;642;628;2399;2372;2312;2288;1479;1468;1413;1407;920;904;899;881;614;647;661;688;
2405075;"Toszek - obszar wiejski (5)";5831;5830;5818;5825;991;993;984;992;3790;3782;3774;3787;2302;2283;2264;2259;1488;1499;1510;1528;1050;1055;1060;1046;
2405082;"Wielowieś (2)";5922;5906;5903;5919;1033;1023;997;979;3876;3868;3870;3880;2401;2374;2334;2328;1475;1494;1536;1552;1013;1015;1036;1060;
2406013;"Kłobuck (3)";20735;20712;20629;20555;3697;3666;3581;3506;13161;13072;12967;12882;8105;8025;7924;7852;5056;5047;5043;5030;3877;3974;4081;4167;
2406014;"Kłobuck - miasto (4)";13281;13246;13133;13086;2249;2217;2158;2139;8382;8311;8168;8071;5043;4977;4891;4825;3339;3334;3277;3246;2650;2718;2807;2876;
2406015;"Kłobuck - obszar wiejski (5)";7454;7466;7496;7469;1448;1449;1423;1367;4779;4761;4799;4811;3062;3048;3033;3027;1717;1713;1766;1784;1227;1256;1274;1291;
2406023;"Krzepice (3)";9297;9225;9197;9248;1601;1560;1548;1529;5883;5845;5787;5788;3586;3553;3541;3574;2297;2292;2246;2214;1813;1820;1862;1931;
2406024;"Krzepice - miasto (4)";4492;4460;4462;4484;767;756;767;764;2881;2841;2785;2768;1748;1732;1713;1719;1133;1109;1072;1049;844;863;910;952;
2406025;"Krzepice - obszar wiejski (5)";4805;4765;4735;4764;834;804;781;765;3002;3004;3002;3020;1838;1821;1828;1855;1164;1183;1174;1165;969;957;952;979;
2406032;"Lipie (2)";6462;6425;6422;6377;1183;1129;1101;1064;4091;4112;4082;4044;2544;2537;2531;2496;1547;1575;1551;1548;1188;1184;1239;1269;
2406042;"Miedźno (2)";7647;7630;7622;7606;1413;1367;1358;1358;4875;4878;4857;4830;3061;3055;3022;2974;1814;1823;1835;1856;1359;1385;1407;1418;
2406052;"Opatów (2)";6868;6862;6872;6837;1287;1248;1247;1246;4350;4372;4370;4325;2787;2777;2773;2718;1563;1595;1597;1607;1231;1242;1255;1266;
2406062;"Panki (2)";5102;5092;5081;5099;950;912;898;902;3187;3210;3204;3213;2037;2046;2034;2045;1150;1164;1170;1168;965;970;979;984;
2406072;"Popów (2)";6036;5996;5988;5961;1121;1075;1060;1032;3831;3824;3794;3781;2412;2428;2393;2363;1419;1396;1401;1418;1084;1097;1134;1148;
2406082;"Przystajń (2)";5961;5972;5937;5889;1118;1105;1066;1042;3745;3750;3746;3693;2303;2306;2324;2288;1442;1444;1422;1405;1098;1117;1125;1154;
2406092;"Wręczyca Wielka (2)";17627;17662;17648;17684;3286;3255;3182;3148;11195;11192;11200;11206;7047;6995;6956;6973;4148;4197;4244;4233;3146;3215;3266;3330;
2407011;"Lubliniec (1)";24394;24316;24182;24105;4207;4160;4086;4059;15864;15709;15499;15319;9715;9589;9423;9330;6149;6120;6076;5989;4323;4447;4597;4727;
2407022;"Boronów (2)";3329;3342;3371;3341;605;585;587;575;2198;2208;2213;2174;1344;1349;1355;1332;854;859;858;842;526;549;571;592;
2407032;"Ciasna (2)";7742;7700;7632;7577;1407;1378;1326;1260;5046;5007;4958;4949;3169;3099;3019;3001;1877;1908;1939;1948;1289;1315;1348;1368;
2407042;"Herby (2)";6932;6876;6886;6905;1317;1304;1287;1311;4437;4375;4356;4313;2741;2694;2696;2684;1696;1681;1660;1629;1178;1197;1243;1281;
2407052;"Kochanowice (2)";6850;6866;6891;6872;1307;1295;1279;1277;4519;4530;4575;4532;2895;2880;2899;2864;1624;1650;1676;1668;1024;1041;1037;1063;
2407062;"Koszęcin (2)";11816;11833;11765;11859;2268;2270;2220;2233;7533;7499;7397;7411;4734;4682;4609;4615;2799;2817;2788;2796;2015;2064;2148;2215;
2407072;"Pawonków (2)";6592;6563;6612;6624;1263;1230;1241;1209;4307;4299;4311;4339;2755;2731;2721;2743;1552;1568;1590;1596;1022;1034;1060;1076;
2407083;"Woźniki (3)";9692;9709;9641;9668;1830;1801;1754;1771;6198;6184;6126;6089;3868;3872;3847;3814;2330;2312;2279;2275;1664;1724;1761;1808;
2407084;"Woźniki - miasto (4)";4457;4463;4422;4408;808;801;763;764;2869;2840;2810;2777;1756;1752;1741;1717;1113;1088;1069;1060;780;822;849;867;
2407085;"Woźniki - obszar wiejski (5)";5235;5246;5219;5260;1022;1000;991;1007;3329;3344;3316;3312;2112;2120;2106;2097;1217;1224;1210;1215;884;902;912;941;
2408011;"Łaziska Górne (1)";22467;22460;22419;22413;4039;3994;3976;4011;14813;14745;14611;14463;9078;9067;9009;8880;5735;5678;5602;5583;3615;3721;3832;3939;
2408021;"Mikołów (1)";39597;39776;39795;39923;7141;7193;7193;7267;25404;25221;24986;24738;15596;15564;15458;15339;9808;9657;9528;9399;7052;7362;7616;7918;
2408031;"Orzesze (1)";19823;20000;20194;20346;3822;3843;3896;3926;12743;12817;12882;12883;7953;7971;8014;8023;4790;4846;4868;4860;3258;3340;3416;3537;
2408042;"Ornontowice (2)";5912;5941;5963;5938;1191;1187;1190;1194;3885;3874;3853;3818;2531;2532;2511;2463;1354;1342;1342;1355;836;880;920;926;
2408052;"Wyry (2)";7418;7592;7736;7837;1548;1622;1665;1678;4761;4836;4899;4967;3042;3106;3175;3203;1719;1730;1724;1764;1109;1134;1172;1192;
2409011;"Myszków (1)";32694;32619;32499;32327;5377;5297;5242;5164;21220;21054;20714;20399;12587;12543;12410;12291;8633;8511;8304;8108;6097;6268;6543;6764;
2409023;"Koziegłowy (3)";14366;14370;14394;14390;2431;2444;2450;2448;8988;8922;8879;8834;5439;5427;5420;5388;3549;3495;3459;3446;2947;3004;3065;3108;
2409024;"Koziegłowy - miasto (4)";2475;2438;2449;2469;406;393;395;409;1565;1533;1528;1529;927;906;908;906;638;627;620;623;504;512;526;531;
2409025;"Koziegłowy - obszar wiejski (5)";11891;11932;11945;11921;2025;2051;2055;2039;7423;7389;7351;7305;4512;4521;4512;4482;2911;2868;2839;2823;2443;2492;2539;2577;
2409032;"Niegowa (2)";5707;5703;5721;5714;1134;1115;1103;1089;3573;3582;3600;3582;2287;2288;2318;2308;1286;1294;1282;1274;1000;1006;1018;1043;
2409042;"Poraj (2)";10892;10982;10957;10931;1746;1761;1754;1722;6806;6805;6732;6647;3995;4021;3991;3936;2811;2784;2741;2711;2340;2416;2471;2562;
2409053;"Żarki (3)";8305;8377;8406;8422;1589;1588;1590;1579;5237;5224;5204;5180;3215;3228;3200;3211;2022;1996;2004;1969;1479;1565;1612;1663;
2409054;"Żarki - miasto (4)";4461;4486;4526;4549;845;842;856;845;2829;2808;2801;2809;1738;1734;1740;1749;1091;1074;1061;1060;787;836;869;895;
2409055;"Żarki - obszar wiejski (5)";3844;3891;3880;3873;744;746;734;734;2408;2416;2403;2371;1477;1494;1460;1462;931;922;943;909;692;729;743;768;
2410012;"Goczałkowice-Zdrój (2)";6608;6605;6643;6674;1311;1278;1279;1266;4201;4200;4184;4196;2633;2615;2612;2614;1568;1585;1572;1582;1096;1127;1180;1212;
2410022;"Kobiór (2)";4870;4902;4898;4918;942;936;925;932;3136;3146;3142;3127;1947;1938;1948;1943;1189;1208;1194;1184;792;820;831;859;
2410032;"Miedźna (2)";16102;16069;16070;16175;3259;3239;3217;3215;11406;11336;11290;11337;6979;6846;6777;6813;4427;4490;4513;4524;1437;1494;1563;1623;
2410042;"Pawłowice (2)";18015;18042;18087;18123;3816;3810;3810;3800;12209;12150;12119;12042;7530;7492;7450;7392;4679;4658;4669;4650;1990;2082;2158;2281;
2410053;"Pszczyna (3)";51271;51423;51712;51928;10285;10356;10428;10476;32844;32676;32626;32510;20684;20563;20522;20396;12160;12113;12104;12114;8142;8391;8658;8942;
2410054;"Pszczyna - miasto (4)";26003;25999;26028;25990;4656;4688;4707;4701;16683;16472;16300;16089;10250;10158;10069;9934;6433;6314;6231;6155;4664;4839;5021;5200;
2410055;"Pszczyna - obszar wiejski (5)";25268;25424;25684;25938;5629;5668;5721;5775;16161;16204;16326;16421;10434;10405;10453;10462;5727;5799;5873;5959;3478;3552;3637;3742;
2410062;"Suszec (2)";11791;11869;11999;12034;2708;2718;2734;2767;7684;7716;7785;7742;4979;4979;4999;4909;2705;2737;2786;2833;1399;1435;1480;1525;
2411011;"Racibórz (1)";56084;55930;55710;55492;8875;8693;8575;8446;37183;36829;36352;35839;22428;22214;21840;21591;14755;14615;14512;14248;10026;10408;10783;11207;
2411022;"Kornowac (2)";5012;5036;5053;5139;1001;1009;991;1022;3234;3224;3241;3267;2048;2035;2044;2046;1186;1189;1197;1221;777;803;821;850;
2411033;"Krzanowice (3)";5882;5864;5847;5820;942;936;928;918;3936;3909;3873;3826;2394;2367;2341;2297;1542;1542;1532;1529;1004;1019;1046;1076;
2411034;"Krzanowice - miasto (4)";2218;2195;2209;2196;351;346;349;344;1463;1445;1448;1425;905;890;895;872;558;555;553;553;404;404;412;427;
2411035;"Krzanowice - obszar wiejski (5)";3664;3669;3638;3624;591;590;579;574;2473;2464;2425;2401;1489;1477;1446;1425;984;987;979;976;600;615;634;649;
2411042;"Krzyżanowice (2)";11439;11342;11350;11328;1968;1954;1936;1928;7474;7394;7404;7348;4576;4501;4477;4427;2898;2893;2927;2921;1997;1994;2010;2052;
2411053;"Kuźnia Raciborska (3)";12029;12008;11963;11909;2009;1991;1963;1911;7952;7905;7870;7779;4808;4735;4654;4556;3144;3170;3216;3223;2068;2112;2130;2219;
2411054;"Kuźnia Raciborska - miasto (4)";5504;5500;5451;5420;945;959;932;897;3656;3593;3553;3510;2203;2156;2106;2077;1453;1437;1447;1433;903;948;966;1013;
2411055;"Kuźnia Raciborska - obszar wiejski (5)";6525;6508;6512;6489;1064;1032;1031;1014;4296;4312;4317;4269;2605;2579;2548;2479;1691;1733;1769;1790;1165;1164;1164;1206;
2411062;"Nędza (2)";7348;7330;7355;7374;1192;1173;1183;1161;4943;4949;4940;4951;3058;3041;3027;3002;1885;1908;1913;1949;1213;1208;1232;1262;
2411072;"Pietrowice Wielkie (2)";6957;6897;6906;6963;1149;1109;1128;1137;4582;4555;4513;4522;2864;2830;2783;2781;1718;1725;1730;1741;1226;1233;1265;1304;
2411082;"Rudnik (2)";5178;5157;5178;5136;873;864;870;845;3354;3342;3348;3313;2028;2007;1999;1967;1326;1335;1349;1346;951;951;960;978;
2412013;"Czerwionka-Leszczyny (3)";41981;42077;42025;42024;7826;7835;7756;7790;27261;27150;27039;26870;16666;16580;16514;16357;10595;10570;10525;10513;6894;7092;7230;7364;
2412014;"Czerwionka-Leszczyny - miasto (4)";28534;28480;28348;28285;5243;5226;5153;5200;18734;18577;18449;18273;11330;11214;11115;10974;7404;7363;7334;7299;4557;4677;4746;4812;
2412015;"Czerwionka-Leszczyny - obszar wiejski (5)";13447;13597;13677;13739;2583;2609;2603;2590;8527;8573;8590;8597;5336;5366;5399;5383;3191;3207;3191;3214;2337;2415;2484;2552;
2412022;"Gaszowice (2)";9220;9260;9371;9495;1819;1846;1878;1909;5902;5842;5882;5919;3772;3745;3769;3777;2130;2097;2113;2142;1499;1572;1611;1667;
2412032;"Jejkowice (2)";3990;4009;4045;4084;851;844;850;852;2599;2610;2631;2649;1648;1658;1662;1704;951;952;969;945;540;555;564;583;
2412042;"Lyski (2)";9490;9573;9603;9600;1672;1678;1661;1638;6184;6212;6208;6182;3857;3868;3855;3808;2327;2344;2353;2374;1634;1683;1734;1780;
2412052;"Świerklany (2)";11916;11996;12106;12228;2566;2580;2598;2605;7606;7597;7642;7683;4923;4935;4975;4977;2683;2662;2667;2706;1744;1819;1866;1940;
2413011;"Kalety (1)";8658;8607;8626;8642;1365;1354;1330;1328;5713;5643;5659;5631;3462;3381;3390;3361;2251;2262;2269;2270;1580;1610;1637;1683;
2413021;"Miasteczko Śląskie (1)";7494;7463;7383;7359;1333;1297;1278;1258;4742;4690;4585;4563;2902;2862;2781;2752;1840;1828;1804;1811;1419;1476;1520;1538;
2413031;"Radzionków (1)";17141;17025;17050;17002;2957;2910;2889;2847;11023;10861;10787;10651;6708;6598;6558;6510;4315;4263;4229;4141;3161;3254;3374;3504;
2413041;"Tarnowskie Góry (1)";61002;60957;60879;61041;10070;10069;10027;10102;39069;38577;38096;37697;23827;23671;23478;23283;15242;14906;14618;14414;11863;12311;12756;13242;
2413052;"Krupski Młyn (2)";3318;3298;3265;3239;566;543;527;508;2099;2089;2053;2026;1271;1280;1254;1224;828;809;799;802;653;666;685;705;
2413062;"Ożarowice (2)";5596;5625;5655;5704;987;985;989;993;3553;3568;3562;3578;2188;2218;2212;2224;1365;1350;1350;1354;1056;1072;1104;1133;
2413072;"Świerklaniec (2)";11582;11650;11814;11846;2058;2086;2113;2117;7522;7497;7561;7501;4639;4618;4686;4648;2883;2879;2875;2853;2002;2067;2140;2228;
2413082;"Tworóg (2)";8126;8088;8073;8146;1459;1454;1412;1398;5186;5134;5155;5193;3189;3132;3133;3147;1997;2002;2022;2046;1481;1500;1506;1555;
2413092;"Zbrosławice (2)";15853;15638;15757;15858;2603;2626;2642;2666;10391;10126;10168;10172;6363;6202;6232;6223;4028;3924;3936;3949;2859;2886;2947;3020;
2414011;"Bieruń (1)";19681;19696;19636;19597;3633;3596;3604;3636;13473;13399;13195;12951;8222;8127;7986;7801;5251;5272;5209;5150;2575;2701;2837;3010;
2414021;"Imielin (1)";8542;8621;8723;8846;1686;1686;1717;1729;5403;5446;5472;5540;3325;3359;3388;3436;2078;2087;2084;2104;1453;1489;1534;1577;
2414031;"Lędziny (1)";16665;16737;16749;16784;3186;3179;3191;3220;11075;11087;11030;10979;6864;6808;6725;6653;4211;4279;4305;4326;2404;2471;2528;2585;
2414042;"Bojszowy (2)";7247;7411;7534;7616;1512;1580;1589;1610;4682;4758;4836;4848;3015;3042;3095;3098;1667;1716;1741;1750;1053;1073;1109;1158;
2414052;"Chełm Śląski (2)";6069;6132;6173;6130;1153;1142;1142;1124;3869;3895;3890;3837;2406;2428;2422;2369;1463;1467;1468;1468;1047;1095;1141;1169;
2415011;"Pszów (1)";14269;14252;14293;14186;2507;2484;2473;2431;9216;9184;9168;9071;5603;5582;5540;5447;3613;3602;3628;3624;2546;2584;2652;2684;
2415021;"Radlin (1)";18146;17984;18028;17913;3434;3362;3359;3312;11553;11388;11349;11230;7126;7016;7009;6881;4427;4372;4340;4349;3159;3234;3320;3371;
2415031;"Rydułtowy (1)";21928;21847;21763;21741;3748;3750;3763;3778;14050;13877;13683;13544;8647;8554;8437;8355;5403;5323;5246;5189;4130;4220;4317;4419;
2415041;"Wodzisław Śląski (1)";49238;48731;48864;48677;8508;8265;8294;8223;31040;30519;30385;30073;19002;18621;18569;18299;12038;11898;11816;11774;9690;9947;10185;10381;
2415052;"Godów (2)";13305;13429;13468;13528;2575;2616;2577;2558;8546;8523;8506;8523;5352;5321;5326;5340;3194;3202;3180;3183;2184;2290;2385;2447;
2415062;"Gorzyce (2)";20644;20678;20762;20866;4017;3981;3971;3941;13098;13058;13056;13052;8188;8186;8166;8208;4910;4872;4890;4844;3529;3639;3735;3873;
2415072;"Lubomia (2)";8009;7961;7946;7932;1489;1449;1432;1443;5172;5169;5137;5066;3214;3210;3182;3150;1958;1959;1955;1916;1348;1343;1377;1423;
2415082;"Marklowice (2)";5452;5450;5439;5440;1140;1103;1093;1081;3296;3329;3304;3305;2096;2129;2108;2098;1200;1200;1196;1207;1016;1018;1042;1054;
2415092;"Mszana (2)";7409;7455;7466;7548;1491;1469;1488;1505;4773;4829;4781;4797;3041;3057;3024;3031;1732;1772;1757;1766;1145;1157;1197;1246;
2416011;"Poręba (1)";8833;8801;8749;8675;1438;1429;1386;1361;5523;5466;5408;5306;3265;3246;3223;3166;2258;2220;2185;2140;1872;1906;1955;2008;
2416021;"Zawiercie (1)";51688;51258;50990;50642;8056;7929;7865;7784;32882;32200;31560;30922;19338;19105;18878;18495;13544;13095;12682;12427;10750;11129;11565;11936;
2416032;"Irządze (2)";2808;2786;2746;2731;484;464;449;440;1668;1668;1660;1648;1037;1040;1031;1026;631;628;629;622;656;654;637;643;
2416042;"Kroczyce (2)";6333;6352;6331;6300;1237;1222;1197;1160;3904;3919;3890;3877;2440;2448;2411;2387;1464;1471;1479;1490;1192;1211;1244;1263;
2416053;"Łazy (3)";16120;16101;16054;16038;2511;2506;2525;2541;10386;10328;10196;10057;6083;6071;6030;5961;4303;4257;4166;4096;3223;3267;3333;3440;
2416054;"Łazy - miasto (4)";7089;7047;6972;6977;1092;1091;1087;1116;4621;4563;4465;4411;2706;2655;2620;2608;1915;1908;1845;1803;1376;1393;1420;1450;
2416055;"Łazy - obszar wiejski (5)";9031;9054;9082;9061;1419;1415;1438;1425;5765;5765;5731;5646;3377;3416;3410;3353;2388;2349;2321;2293;1847;1874;1913;1990;
2416063;"Ogrodzieniec (3)";9451;9383;9307;9223;1475;1452;1433;1400;5981;5897;5805;5730;3548;3486;3464;3421;2433;2411;2341;2309;1995;2034;2069;2093;
2416064;"Ogrodzieniec - miasto (4)";4412;4379;4349;4309;653;640;640;618;2823;2793;2749;2729;1688;1650;1649;1626;1135;1143;1100;1103;936;946;960;962;
2416065;"Ogrodzieniec - obszar wiejski (5)";5039;5004;4958;4914;822;812;793;782;3158;3104;3056;3001;1860;1836;1815;1795;1298;1268;1241;1206;1059;1088;1109;1131;
2416073;"Pilica (3)";8924;8877;8778;8725;1521;1480;1422;1408;5550;5534;5483;5454;3428;3425;3375;3334;2122;2109;2108;2120;1853;1863;1873;1863;
2416074;"Pilica - miasto (4)";1970;1948;1937;1928;290;279;276;279;1240;1231;1215;1213;733;723;719;716;507;508;496;497;440;438;446;436;
2416075;"Pilica - obszar wiejski (5)";6954;6929;6841;6797;1231;1201;1146;1129;4310;4303;4268;4241;2695;2702;2656;2618;1615;1601;1612;1623;1413;1425;1427;1427;
2416083;"Szczekociny (3)";8089;8046;8003;7963;1331;1287;1262;1255;5067;5026;4946;4912;2973;2995;2979;2962;2094;2031;1967;1950;1691;1733;1795;1796;
2416084;"Szczekociny - miasto (4)";3772;3745;3726;3728;603;576;556;554;2461;2423;2373;2346;1407;1397;1379;1368;1054;1026;994;978;708;746;797;828;
2416085;"Szczekociny - obszar wiejski (5)";4317;4301;4277;4235;728;711;706;701;2606;2603;2573;2566;1566;1598;1600;1594;1040;1005;973;972;983;987;998;968;
2416092;"Włodowice (2)";5289;5299;5297;5244;904;901;903;862;3398;3373;3352;3296;2048;2036;2020;1971;1350;1337;1332;1325;987;1025;1042;1086;
2416102;"Żarnowiec (2)";4790;4780;4757;4729;966;938;929;914;2891;2899;2863;2821;1784;1804;1785;1778;1107;1095;1078;1043;933;943;965;994;
2417011;"Żywiec (1)";32341;32083;31942;31815;5750;5646;5618;5535;20320;19965;19680;19446;12762;12529;12356;12206;7558;7436;7324;7240;6271;6472;6644;6834;
2417022;"Czernichów (2)";6744;6773;6800;6798;1218;1182;1173;1141;4345;4356;4364;4328;2617;2626;2619;2590;1728;1730;1745;1738;1181;1235;1263;1329;
2417032;"Gilowice (2)";6052;6121;6144;6193;1273;1271;1254;1261;3754;3788;3801;3817;2414;2437;2453;2471;1340;1351;1348;1346;1025;1062;1089;1115;
2417042;"Jeleśnia (2)";13474;13478;13426;13401;2645;2582;2532;2480;8473;8521;8457;8441;5352;5366;5314;5293;3121;3155;3143;3148;2356;2375;2437;2480;
2417052;"Koszarawa (2)";2450;2446;2450;2428;473;445;433;435;1576;1598;1607;1567;951;958;967;938;625;640;640;629;401;403;410;426;
2417062;"Lipowa (2)";10286;10320;10441;10474;2166;2119;2122;2106;6583;6624;6689;6683;4209;4251;4308;4301;2374;2373;2381;2382;1537;1577;1630;1685;
2417072;"Łękawica (2)";4448;4458;4477;4454;930;903;902;873;2836;2849;2863;2863;1803;1828;1837;1822;1033;1021;1026;1041;682;706;712;718;
2417082;"Łodygowice (2)";13726;13825;13940;14054;2649;2657;2683;2709;8825;8844;8882;8898;5566;5593;5629;5639;3259;3251;3253;3259;2252;2324;2375;2447;
2417092;"Milówka (2)";10104;10107;10104;10090;2063;2024;2012;1966;6356;6364;6333;6336;4135;4171;4111;4097;2221;2193;2222;2239;1685;1719;1759;1788;
2417102;"Radziechowy-Wieprz (2)";12997;13048;13097;13088;2751;2691;2679;2632;8271;8362;8354;8350;5311;5362;5312;5307;2960;3000;3042;3043;1975;1995;2064;2106;
2417112;"Rajcza (2)";9094;9062;9025;8988;1715;1648;1611;1592;5655;5647;5619;5591;3574;3565;3547;3519;2081;2082;2072;2072;1724;1767;1795;1805;
2417122;"Ślemień (2)";3521;3502;3501;3524;686;671;659;660;2244;2229;2234;2228;1406;1399;1391;1402;838;830;843;826;591;602;608;636;
2417132;"Świnna (2)";8074;8120;8102;8082;1662;1654;1609;1587;5005;5014;5037;5013;3219;3230;3230;3186;1786;1784;1807;1827;1407;1452;1456;1482;
2417142;"Ujsoły (2)";4685;4638;4609;4556;894;854;818;790;2862;2837;2837;2811;1782;1770;1768;1758;1080;1067;1069;1053;929;947;954;955;
2417152;"Węgierska Górka (2)";15123;15127;15131;15102;3100;3055;3038;2996;9549;9560;9520;9478;6078;6055;6009;5973;3471;3505;3511;3505;2474;2512;2573;2628;
2461011;"Bielsko-Biała (1)";174370;173699;173013;172591;29361;29292;29239;29178;109546;107644;105749;104028;67305;66508;65762;65005;42241;41136;39987;39023;35463;36763;38025;39385;
2462011;"Bytom (1)";174724;173439;172306;170761;28259;27878;27460;27027;111570;109942;108369;106548;68265;67297;66242;65199;43305;42645;42127;41349;34895;35619;36477;37186;
2463011;"Chorzów (1)";111168;110761;110337;109757;18789;18726;18659;18543;69139;68460;67710;66975;43244;42881;42487;41871;25895;25579;25223;25104;23240;23575;23968;24239;
2464011;"Częstochowa (1)";234472;232318;230123;228179;35782;35367;34852;34511;149460;146254;143075;139722;87817;86365;84834;83057;61643;59889;58241;56665;49230;50697;52196;53946;
2465011;"Dąbrowa Górnicza (1)";124701;123994;123376;122712;18950;18912;18901;18846;82645;80948;79148;77226;48321;47633;47064;46441;34324;33315;32084;30785;23106;24134;25327;26640;
2466011;"Gliwice (1)";186210;185450;184415;183392;29076;28924;28844;28894;120248;118510;116436;114133;73480;72930;71850;70499;46768;45580;44586;43634;36886;38016;39135;40365;
2467011;"Jastrzębie-Zdrój (1)";91723;91235;90794;90283;16817;16434;16032;15709;57369;56474;55805;55155;37093;36494;35853;35145;20276;19980;19952;20010;17537;18327;18957;19419;
2468011;"Jaworzno (1)";94305;93708;93331;92847;15284;15032;14917;14819;61731;61025;60253;59410;36866;36376;35990;35459;24865;24649;24263;23951;17290;17651;18161;18618;
2469011;"Katowice (1)";307233;304362;301834;299910;44188;43740;43144;43062;196063;192198;188581;185081;117553;115374;113394;111507;78510;76824;75187;73574;66982;68424;70109;71767;
2470011;"Mysłowice (1)";75305;75129;75037;74851;12932;12892;12958;13020;49660;49122;48531;47876;29875;29633;29361;28925;19785;19489;19170;18951;12713;13115;13548;13955;
2471011;"Piekary Śląskie (1)";57502;57148;56755;56374;9468;9370;9304;9178;37132;36618;35969;35388;22106;21838;21543;21311;15026;14780;14426;14077;10902;11160;11482;11808;
2472011;"Ruda Śląska (1)";142346;141521;140669;139844;25000;24770;24600;24487;92133;90862;89373;87944;55421;54800;54132;53492;36712;36062;35241;34452;25213;25889;26696;27413;
2473011;"Rybnik (1)";140789;140173;140052;139595;25239;25048;25063;25002;91794;90659;89565;88267;56460;55909;55447;54813;35334;34750;34118;33454;23756;24466;25424;26326;
2474011;"Siemianowice Śląskie (1)";69539;68844;68634;68231;11111;10890;10857;10889;44653;43875;43310;42503;26558;26182;25969;25594;18095;17693;17341;16909;13775;14079;14467;14839;
2475011;"Sosnowiec (1)";213513;211275;209274;207381;30328;30025;29553;29383;138918;135441;132066;128479;80699;79382;78255;76800;58219;56059;53811;51679;44267;45809;47655;49519;
2476011;"Świętochłowice (1)";52372;51824;51494;50970;8858;8723;8645;8533;33691;33018;32447;31726;20234;19787;19499;19172;13457;13231;12948;12554;9823;10083;10402;10711;
2477011;"Tychy (1)";129112;128799;128621;128444;21187;21303;21408;21626;85851;84270;82684;81009;51310;50907;50569;50076;34541;33363;32115;30933;22074;23226;24529;25809;
2478011;"Zabrze (1)";179452;178357;177188;176327;28742;28329;27826;27533;117028;115567;113825;112267;70621;69452;68265;67245;46407;46115;45560;45022;33682;34461;35537;36527;
2479011;"Żory (1)";62052;62038;62051;61945;11870;11916;11944;11878;41481;40656;39883;39120;25858;25677;25561;25390;15623;14979;14322;13730;8701;9466;10224;10947;
2601013;"Busko-Zdrój (3)";32899;32825;32889;32767;5593;5559;5544;5452;20723;20476;20389;20155;12669;12551;12565;12453;8054;7925;7824;7702;6583;6790;6956;7160;
2601014;"Busko-Zdrój - miasto (4)";16860;16694;16710;16509;2590;2555;2594;2517;10698;10428;10291;10042;6362;6217;6191;6046;4336;4211;4100;3996;3572;3711;3825;3950;
2601015;"Busko-Zdrój - obszar wiejski (5)";16039;16131;16179;16258;3003;3004;2950;2935;10025;10048;10098;10113;6307;6334;6374;6407;3718;3714;3724;3706;3011;3079;3131;3210;
2601022;"Gnojno (2)";4561;4549;4514;4459;861;839;811;778;2722;2734;2712;2686;1715;1733;1728;1717;1007;1001;984;969;978;976;991;995;
2601032;"Nowy Korczyn (2)";6289;6245;6215;6158;1036;1020;1000;967;3837;3807;3772;3745;2316;2308;2296;2289;1521;1499;1476;1456;1416;1418;1443;1446;
2601042;"Pacanów (2)";7720;7639;7597;7481;1365;1280;1256;1221;4595;4611;4568;4481;2881;2886;2841;2773;1714;1725;1727;1708;1760;1748;1773;1779;
2601052;"Solec-Zdrój (2)";5111;5093;5079;5068;940;906;904;883;3139;3150;3124;3119;1931;1935;1924;1928;1208;1215;1200;1191;1032;1037;1051;1066;
2601062;"Stopnica (2)";7819;7810;7771;;1367;1358;1321;;4870;4837;4828;;3017;3004;2976;;1853;1833;1852;;1582;1615;1622;;
2601063;"Stopnica (3)";;;;7744;;;;1331;;;;4767;;;;2942;;;;1825;;;;1646;
2601064;"Stopnica - miasto (4)";;;;1455;;;;248;;;;890;;;;549;;;;341;;;;317;
2601065;"Stopnica - obszar wiejski (5)";;;;6289;;;;1083;;;;3877;;;;2393;;;;1484;;;;1329;
2601072;"Tuczępy (2)";3793;3788;3758;3780;749;719;672;667;2279;2290;2294;2299;1420;1439;1461;1471;859;851;833;828;765;779;792;814;
2601082;"Wiślica (2)";5742;5642;5627;5611;939;903;888;899;3591;3517;3516;3481;2199;2169;2151;2145;1392;1348;1365;1336;1212;1222;1223;1231;
2602012;"Imielno (2)";4456;4453;4470;4450;847;825;818;828;2690;2681;2683;2648;1613;1618;1640;1631;1077;1063;1043;1017;919;947;969;974;
2602023;"Jędrzejów (3)";28972;28837;28709;28584;5220;5100;5039;4962;18218;18018;17774;17529;11290;11217;11118;11020;6928;6801;6656;6509;5534;5719;5896;6093;
2602024;"Jędrzejów - miasto (4)";15982;15851;15698;15578;2628;2554;2520;2493;10051;9862;9605;9374;5974;5926;5822;5751;4077;3936;3783;3623;3303;3435;3573;3711;
2602025;"Jędrzejów - obszar wiejski (5)";12990;12986;13011;13006;2592;2546;2519;2469;8167;8156;8169;8155;5316;5291;5296;5269;2851;2865;2873;2886;2231;2284;2323;2382;
2602033;"Małogoszcz (3)";11788;11749;11698;11670;2437;2364;2334;2277;7491;7439;7350;7307;4781;4765;4712;4741;2710;2674;2638;2566;1860;1946;2014;2086;
2602034;"Małogoszcz - miasto (4)";3975;3929;3872;3857;770;745;740;717;2632;2555;2461;2413;1646;1623;1574;1567;986;932;887;846;573;629;671;727;
2602035;"Małogoszcz - obszar wiejski (5)";7813;7820;7826;7813;1667;1619;1594;1560;4859;4884;4889;4894;3135;3142;3138;3174;1724;1742;1751;1720;1287;1317;1343;1359;
2602042;"Nagłowice (2)";5173;5176;5132;5064;998;976;963;928;3100;3116;3088;3052;1882;1928;1926;1901;1218;1188;1162;1151;1075;1084;1081;1084;
2602052;"Oksa (2)";4695;4690;4662;4610;902;875;859;845;2832;2835;2810;2767;1739;1770;1763;1727;1093;1065;1047;1040;961;980;993;998;
2602063;"Sędziszów (3)";12932;12906;12834;12681;2283;2271;2242;2213;8332;8214;8091;7916;5064;5066;5029;4960;3268;3148;3062;2956;2317;2421;2501;2552;
2602064;"Sędziszów - miasto (4)";6701;6707;6654;6601;1204;1209;1188;1182;4525;4445;4336;4230;2741;2732;2703;2679;1784;1713;1633;1551;972;1053;1130;1189;
2602065;"Sędziszów - obszar wiejski (5)";6231;6199;6180;6080;1079;1062;1054;1031;3807;3769;3755;3686;2323;2334;2326;2281;1484;1435;1429;1405;1345;1368;1371;1363;
2602072;"Słupia (2)";4381;4359;4368;4381;822;811;787;786;2644;2633;2659;2639;1658;1649;1661;1667;986;984;998;972;915;915;922;956;
2602082;"Sobków (2)";8495;8519;8538;8536;1685;1667;1651;1648;5325;5340;5350;5322;3430;3430;3433;3422;1895;1910;1917;1900;1485;1512;1537;1566;
2602092;"Wodzisław (2)";7393;7298;7224;7165;1298;1256;1240;1211;4440;4358;4288;4260;2696;2668;2659;2635;1744;1690;1629;1625;1655;1684;1696;1694;
2603012;"Bejsce (2)";4252;4222;4203;4174;663;634;607;587;2655;2639;2643;2605;1628;1626;1622;1588;1027;1013;1021;1017;934;949;953;982;
2603022;"Czarnocin (2)";3985;3945;3901;3879;660;614;592;562;2469;2485;2460;2471;1501;1505;1484;1500;968;980;976;971;856;846;849;846;
2603033;"Kazimierza Wielka (3)";16774;16591;16503;16426;2660;2565;2534;2491;10723;10613;10479;10376;6573;6505;6401;6334;4150;4108;4078;4042;3391;3413;3490;3559;
2603034;"Kazimierza Wielka - miasto (4)";5832;5748;5725;5665;813;800;801;792;3807;3733;3680;3594;2263;2214;2167;2124;1544;1519;1513;1470;1212;1215;1244;1279;
2603035;"Kazimierza Wielka - obszar wiejski (5)";10942;10843;10778;10761;1847;1765;1733;1699;6916;6880;6799;6782;4310;4291;4234;4210;2606;2589;2565;2572;2179;2198;2246;2280;
2603042;"Opatowiec (2)";3470;3458;3400;3352;552;537;510;481;2134;2131;2079;2058;1289;1290;1259;1249;845;841;820;809;784;790;811;813;
2603053;"Skalbmierz (3)";6794;6727;6682;6618;1269;1225;1186;1163;4151;4115;4090;4024;2587;2555;2523;2490;1564;1560;1567;1534;1374;1387;1406;1431;
2603054;"Skalbmierz - miasto (4)";1340;1315;1313;1291;234;212;203;194;859;848;855;837;517;504;514;504;342;344;341;333;247;255;255;260;
2603055;"Skalbmierz - obszar wiejski (5)";5454;5412;5369;5327;1035;1013;983;969;3292;3267;3235;3187;2070;2051;2009;1986;1222;1216;1226;1201;1127;1132;1151;1171;
2604012;"Bieliny (2)";10131;10149;10171;10213;2271;2251;2222;2206;6496;6516;6522;6541;4364;4337;4339;4336;2132;2179;2183;2205;1364;1382;1427;1466;
2604023;"Bodzentyn (3)";11749;11729;11697;11638;2264;2213;2177;2120;7524;7541;7510;7470;4740;4752;4745;4739;2784;2789;2765;2731;1961;1975;2010;2048;
2604024;"Bodzentyn - miasto (4)";2290;2274;2255;2240;385;381;382;361;1494;1476;1442;1439;912;894;879;880;582;582;563;559;411;417;431;440;
2604025;"Bodzentyn - obszar wiejski (5)";9459;9455;9442;9398;1879;1832;1795;1759;6030;6065;6068;6031;3828;3858;3866;3859;2202;2207;2202;2172;1550;1558;1579;1608;
2604033;"Chęciny (3)";15136;15082;15022;15014;2876;2829;2798;2763;9865;9771;9653;9587;6256;6215;6136;6095;3609;3556;3517;3492;2395;2482;2571;2664;
2604034;"Chęciny - miasto (4)";4448;4438;4433;4419;765;764;761;754;3002;2954;2911;2849;1866;1855;1827;1798;1136;1099;1084;1051;681;720;761;816;
2604035;"Chęciny - obszar wiejski (5)";10688;10644;10589;10595;2111;2065;2037;2009;6863;6817;6742;6738;4390;4360;4309;4297;2473;2457;2433;2441;1714;1762;1810;1848;
2604043;"Chmielnik (3)";11572;11566;11477;11444;2229;2185;2120;2093;7246;7220;7170;7111;4521;4517;4501;4494;2725;2703;2669;2617;2097;2161;2187;2240;
2604044;"Chmielnik - miasto (4)";3937;3921;3877;3841;693;685;663;649;2499;2468;2444;2395;1502;1477;1464;1443;997;991;980;952;745;768;770;797;
2604045;"Chmielnik - obszar wiejski (5)";7635;7645;7600;7603;1536;1500;1457;1444;4747;4752;4726;4716;3019;3040;3037;3051;1728;1712;1689;1665;1352;1393;1417;1443;
2604053;"Daleszyce (3)";15534;15556;15625;15647;3188;3120;3044;2987;10196;10219;10299;10301;6663;6707;6726;6698;3533;3512;3573;3603;2150;2217;2282;2359;
2604054;"Daleszyce - miasto (4)";2929;2911;2915;2911;548;535;527;516;1937;1924;1932;1927;1249;1256;1261;1258;688;668;671;669;444;452;456;468;
2604055;"Daleszyce - obszar wiejski (5)";12605;12645;12710;12736;2640;2585;2517;2471;8259;8295;8367;8374;5414;5451;5465;5440;2845;2844;2902;2934;1706;1765;1826;1891;
2604062;"Górno (2)";13710;13770;13881;13977;3060;3014;2979;2960;9033;9060;9139;9156;6044;6041;6106;6114;2989;3019;3033;3042;1617;1696;1763;1861;
2604072;"Łagów (2)";7018;6978;6922;6954;1411;1346;1303;1314;4398;4425;4401;4392;2843;2857;2836;2821;1555;1568;1565;1571;1209;1207;1218;1248;
2604082;"Łopuszno (2)";9080;9038;9043;8989;1886;1825;1813;1754;5725;5712;5699;5689;3748;3751;3721;3708;1977;1961;1978;1981;1469;1501;1531;1546;
2604092;"Masłów (2)";10468;10468;10565;10602;2125;2064;2055;2019;6985;6989;7031;7038;4503;4515;4532;4519;2482;2474;2499;2519;1358;1415;1479;1545;
2604102;"Miedziana Góra (2)";10949;11074;11182;11260;2218;2232;2232;2212;7289;7347;7385;7400;4715;4732;4741;4747;2574;2615;2644;2653;1442;1495;1565;1648;
2604112;"Mniów (2)";9387;9346;9355;9349;2038;1978;1942;1889;6035;6016;6014;6035;3960;3946;3930;3940;2075;2070;2084;2095;1314;1352;1399;1425;
2604122;"Morawica (2)";15129;15373;15603;15801;3305;3322;3363;3397;9979;10104;10207;10240;6586;6650;6700;6675;3393;3454;3507;3565;1845;1947;2033;2164;
2604132;"Nowa Słupia (2)";9708;9673;9636;9635;1671;1621;1578;1581;6223;6210;6173;6132;3823;3846;3850;3846;2400;2364;2323;2286;1814;1842;1885;1922;
2604142;"Piekoszów (2)";16146;16284;16286;16321;3437;3415;3307;3296;10537;10638;10661;10635;6924;6983;6973;6928;3613;3655;3688;3707;2172;2231;2318;2390;
2604152;"Pierzchnica (2)";4836;4814;4821;4793;978;951;930;898;2987;2997;3006;3009;1883;1886;1873;1878;1104;1111;1133;1131;871;866;885;886;
2604162;"Raków (2)";5797;5762;5729;5716;1066;1056;995;985;3571;3539;3544;3546;2215;2206;2199;2185;1356;1333;1345;1361;1160;1167;1190;1185;
2604172;"Sitkówka-Nowiny (2)";7531;7587;7651;7708;1498;1492;1500;1501;4848;4858;4869;4880;3149;3159;3170;3180;1699;1699;1699;1700;1185;1237;1282;1327;
2604182;"Strawczyn (2)";10288;10346;10453;10505;2272;2240;2220;2204;6729;6777;6848;6867;4502;4544;4604;4592;2227;2233;2244;2275;1287;1329;1385;1434;
2604192;"Zagnańsk (2)";12916;12993;12947;12960;2189;2225;2142;2130;8437;8429;8430;8394;5246;5213;5219;5186;3191;3216;3211;3208;2290;2339;2375;2436;
2605012;"Fałków (2)";4716;4634;4621;4559;835;785;791;758;2874;2818;2780;2739;1773;1740;1719;1714;1101;1078;1061;1025;1007;1031;1050;1062;
2605022;"Gowarczów (2)";4748;4760;4720;4700;917;891;865;836;2977;2985;2952;2936;1884;1911;1884;1884;1093;1074;1068;1052;854;884;903;928;
2605033;"Końskie (3)";36727;36450;36276;36048;6184;6068;5914;5776;23232;22832;22577;22234;14110;13902;13789;13579;9122;8930;8788;8655;7311;7550;7785;8038;
2605034;"Końskie - miasto (4)";20530;20281;20059;19845;3141;3072;2978;2910;12992;12636;12323;11991;7637;7455;7329;7156;5355;5181;4994;4835;4397;4573;4758;4944;
2605035;"Końskie - obszar wiejski (5)";16197;16169;16217;16203;3043;2996;2936;2866;10240;10196;10254;10243;6473;6447;6460;6423;3767;3749;3794;3820;2914;2977;3027;3094;
2605042;"Radoszyce (2)";9209;9161;9121;9044;1782;1724;1701;1666;5821;5810;5757;5683;3661;3685;3647;3583;2160;2125;2110;2100;1606;1627;1663;1695;
2605052;"Ruda Maleniecka (2)";3268;3231;3191;3181;550;538;529;534;1954;1917;1883;1873;1182;1162;1135;1117;772;755;748;756;764;776;779;774;
2605062;"Słupia (Konecka) (2)";3456;3442;3431;3429;611;583;581;568;2121;2142;2121;2129;1281;1307;1284;1300;840;835;837;829;724;717;729;732;
2605072;"Smyków (2)";3775;3797;3813;3808;814;809;797;794;2364;2378;2404;2368;1536;1545;1552;1558;828;833;852;810;597;610;612;646;
2605083;"Stąporków (3)";18028;17917;17752;17567;2827;2761;2679;2603;11338;11206;11024;10813;6624;6577;6457;6364;4714;4629;4567;4449;3863;3950;4049;4151;
2605084;"Stąporków - miasto (4)";6085;5996;5947;5914;1014;977;968;950;3954;3835;3731;3632;2339;2297;2243;2227;1615;1538;1488;1405;1117;1184;1248;1332;
2605085;"Stąporków - obszar wiejski (5)";11943;11921;11805;11653;1813;1784;1711;1653;7384;7371;7293;7181;4285;4280;4214;4137;3099;3091;3079;3044;2746;2766;2801;2819;
2606012;"Baćkowice (2)";5050;5049;4984;4958;936;929;916;894;3205;3199;3148;3124;1979;2004;1951;1955;1226;1195;1197;1169;909;921;920;940;
2606022;"Iwaniska (2)";6938;6941;6869;6815;1381;1377;1323;1284;4321;4327;4322;4288;2729;2706;2704;2667;1592;1621;1618;1621;1236;1237;1224;1243;
2606032;"Lipnik (2)";5585;5538;5502;5429;985;945;930;904;3522;3505;3477;3420;2165;2162;2128;2109;1357;1343;1349;1311;1078;1088;1095;1105;
2606043;"Opatów (3)";12381;12227;12102;12030;2066;2003;1934;1880;7807;7668;7571;7450;4545;4476;4454;4424;3262;3192;3117;3026;2508;2556;2597;2700;
2606044;"Opatów - miasto (4)";6822;6767;6657;6613;1106;1096;1043;1001;4320;4226;4137;4065;2550;2498;2465;2444;1770;1728;1672;1621;1396;1445;1477;1547;
2606045;"Opatów - obszar wiejski (5)";5559;5460;5445;5417;960;907;891;879;3487;3442;3434;3385;1995;1978;1989;1980;1492;1464;1445;1405;1112;1111;1120;1153;
2606053;"Ożarów (3)";11185;11080;11067;11031;2053;1987;1968;1926;7202;7076;6997;6884;4330;4314;4325;4306;2872;2762;2672;2578;1930;2017;2102;2221;
2606054;"Ożarów - miasto (4)";4760;4730;4682;4655;825;798;781;765;3277;3210;3097;3000;1952;1943;1915;1898;1325;1267;1182;1102;658;722;804;890;
2606055;"Ożarów - obszar wiejski (5)";6425;6350;6385;6376;1228;1189;1187;1161;3925;3866;3900;3884;2378;2371;2410;2408;1547;1495;1490;1476;1272;1295;1298;1331;
2606062;"Sadowie (2)";4155;4126;4096;4044;703;689;680;672;2590;2579;2551;2480;1608;1589;1572;1539;982;990;979;941;862;858;865;892;
2606072;"Tarłów (2)";5482;5442;5407;5383;909;854;822;828;3372;3396;3395;3339;1993;2039;2056;2053;1379;1357;1339;1286;1201;1192;1190;1216;
2606082;"Wojciechowice (2)";4306;4253;4221;4131;772;759;735;710;2639;2609;2599;2516;1558;1547;1548;1505;1081;1062;1051;1011;895;885;887;905;
2607011;"Ostrowiec Świętokrzyski (1)";72871;72277;71728;70677;11299;11102;10827;10352;46832;45877;44940;43772;26695;26335;25994;25497;20137;19542;18946;18275;14740;15298;15961;16553;
2607022;"Bałtów (2)";3711;3626;3569;3564;641;606;590;580;2286;2232;2205;2211;1399;1355;1340;1336;887;877;865;875;784;788;774;773;
2607032;"Bodzechów (2)";13636;13690;13679;13597;2436;2386;2348;2263;8514;8541;8532;8503;5127;5172;5187;5178;3387;3369;3345;3325;2686;2763;2799;2831;
2607043;"Ćmielów (3)";7731;7694;7625;7550;1335;1286;1254;1211;4775;4771;4701;4647;2832;2845;2807;2777;1943;1926;1894;1870;1621;1637;1670;1692;
2607044;"Ćmielów - miasto (4)";3183;3157;3116;3095;556;523;509;494;1995;1988;1940;1940;1182;1181;1148;1151;813;807;792;789;632;646;667;661;
2607045;"Ćmielów - obszar wiejski (5)";4548;4537;4509;4455;779;763;745;717;2780;2783;2761;2707;1650;1664;1659;1626;1130;1119;1102;1081;989;991;1003;1031;
2607053;"Kunów (3)";10083;10036;10018;10018;1782;1740;1697;1691;6404;6359;6340;6313;3915;3889;3880;3873;2489;2470;2460;2440;1897;1937;1981;2014;
2607054;"Kunów - miasto (4)";3148;3098;3060;3033;550;515;491;484;1970;1944;1912;1880;1197;1182;1169;1152;773;762;743;728;628;639;657;669;
2607055;"Kunów - obszar wiejski (5)";6935;6938;6958;6985;1232;1225;1206;1207;4434;4415;4428;4433;2718;2707;2711;2721;1716;1708;1717;1712;1269;1298;1324;1345;
2607062;"Waśniów (2)";7122;7095;7059;7011;1420;1391;1368;1339;4319;4303;4271;4235;2694;2706;2703;2698;1625;1597;1568;1537;1383;1401;1420;1437;
2608013;"Działoszyce (3)";5295;5252;5221;5143;821;837;814;783;3151;3096;3056;3006;1817;1790;1782;1774;1334;1306;1274;1232;1323;1319;1351;1354;
2608014;"Działoszyce - miasto (4)";1009;981;964;944;147;143;136;128;651;622;605;594;378;356;346;334;273;266;259;260;211;216;223;222;
2608015;"Działoszyce - obszar wiejski (5)";4286;4271;4257;4199;674;694;678;655;2500;2474;2451;2412;1439;1434;1436;1440;1061;1040;1015;972;1112;1103;1128;1132;
2608022;"Kije (2)";4498;4501;4474;4492;794;774;748;747;2742;2763;2758;2759;1677;1703;1688;1692;1065;1060;1070;1067;962;964;968;986;
2608032;"Michałów (2)";4795;4788;4758;4716;912;914;900;882;2857;2832;2808;2787;1788;1777;1760;1750;1069;1055;1048;1037;1026;1042;1050;1047;
2608043;"Pińczów (3)";21645;21421;21307;21192;3661;3525;3425;3355;13742;13579;13511;13344;8185;8110;8111;7999;5557;5469;5400;5345;4242;4317;4371;4493;
2608044;"Pińczów - miasto (4)";11471;11306;11179;11102;1732;1669;1595;1544;7450;7264;7143;7038;4288;4202;4168;4116;3162;3062;2975;2922;2289;2373;2441;2520;
2608045;"Pińczów - obszar wiejski (5)";10174;10115;10128;10090;1929;1856;1830;1811;6292;6315;6368;6306;3897;3908;3943;3883;2395;2407;2425;2423;1953;1944;1930;1973;
2608052;"Złota (2)";4697;4649;4590;4538;765;759;716;699;2875;2821;2790;2750;1690;1657;1639;1634;1185;1164;1151;1116;1057;1069;1084;1089;
2609011;"Sandomierz (1)";24731;24552;24326;24187;4052;3977;3873;3793;15660;15386;15123;14914;9591;9383;9169;8985;6069;6003;5954;5929;5019;5189;5330;5480;
2609022;"Dwikozy (2)";9053;8974;8933;8893;1524;1457;1410;1389;5779;5723;5702;5653;3558;3540;3534;3482;2221;2183;2168;2171;1750;1794;1821;1851;
2609032;"Klimontów (2)";8522;8432;8352;8272;1709;1606;1555;1513;5212;5232;5197;5145;3366;3364;3363;3313;1846;1868;1834;1832;1601;1594;1600;1614;
2609043;"Koprzywnica (3)";6943;6901;6853;6823;1276;1246;1193;1164;4318;4292;4292;4267;2680;2679;2661;2647;1638;1613;1631;1620;1349;1363;1368;1392;
2609044;"Koprzywnica - miasto (4)";2589;2575;2539;2541;462;456;426;418;1649;1626;1622;1628;1006;1002;988;994;643;624;634;634;478;493;491;495;
2609045;"Koprzywnica - obszar wiejski (5)";4354;4326;4314;4282;814;790;767;746;2669;2666;2670;2639;1674;1677;1673;1653;995;989;997;986;871;870;877;897;
2609052;"Łoniów (2)";7505;7542;7526;7540;1461;1433;1405;1382;4652;4671;4641;4616;2975;3003;2995;3002;1677;1668;1646;1614;1392;1438;1480;1542;
2609062;"Obrazów (2)";6603;6591;6591;6570;1199;1154;1124;1106;4015;4039;4050;4008;2527;2557;2572;2520;1488;1482;1478;1488;1389;1398;1417;1456;
2609072;"Samborzec (2)";8733;8657;8634;8596;1515;1499;1469;1441;5424;5331;5315;5280;3353;3308;3290;3286;2071;2023;2025;1994;1794;1827;1850;1875;
2609082;"Wilczyce (2)";3806;3800;3796;3778;665;653;630;622;2405;2401;2401;2392;1527;1524;1530;1515;878;877;871;877;736;746;765;764;
2609093;"Zawichost (3)";4670;4620;4614;4607;863;848;821;815;2848;2794;2790;2758;1726;1700;1703;1698;1122;1094;1087;1060;959;978;1003;1034;
2609094;"Zawichost - miasto (4)";1877;1861;1863;1867;340;346;337;342;1184;1140;1137;1117;725;688;692;681;459;452;445;436;353;375;389;408;
2609095;"Zawichost - obszar wiejski (5)";2793;2759;2751;2740;523;502;484;473;1664;1654;1653;1641;1001;1012;1011;1017;663;642;642;624;606;603;614;626;
2610011;"Skarżysko-Kamienna (1)";47987;47538;47212;46900;6990;6822;6758;6659;30488;29914;29207;28546;17453;17261;16970;16721;13035;12653;12237;11825;10509;10802;11247;11695;
2610022;"Bliżyn (2)";8434;8392;8360;8293;1410;1351;1315;1268;5352;5348;5301;5234;3268;3268;3277;3216;2084;2080;2024;2018;1672;1693;1744;1791;
2610032;"Łączna (2)";5331;5353;5340;5226;1087;1048;1003;980;3353;3368;3343;3319;2166;2161;2140;2136;1187;1207;1203;1183;891;937;994;927;
2610042;"Skarżysko Kościelne (2)";6258;6208;6212;6193;1096;1082;1074;1063;3971;3938;3926;3910;2388;2347;2346;2325;1583;1591;1580;1585;1191;1188;1212;1220;
2610053;"Suchedniów (3)";10626;10581;10523;10427;1637;1570;1536;1482;6766;6723;6657;6566;4046;4019;3983;3969;2720;2704;2674;2597;2223;2288;2330;2379;
2610054;"Suchedniów - miasto (4)";8747;8714;8667;8575;1335;1290;1268;1232;5585;5541;5487;5394;3356;3327;3296;3276;2229;2214;2191;2118;1827;1883;1912;1949;
2610055;"Suchedniów - obszar wiejski (5)";1879;1867;1856;1852;302;280;268;250;1181;1182;1170;1172;690;692;687;693;491;490;483;479;396;405;418;430;
2611011;"Starachowice (1)";51695;51158;50679;50355;7874;7637;7436;7346;32438;31798;31132;30516;18683;18447;18194;17932;13755;13351;12938;12584;11383;11723;12111;12493;
2611022;"Brody (2)";11156;11180;11136;11085;2113;2075;2031;1975;6924;6953;6944;6929;4356;4369;4337;4346;2568;2584;2607;2583;2119;2152;2161;2181;
2611032;"Mirzec (2)";8447;8420;8379;8333;1623;1567;1540;1510;5212;5211;5169;5138;3314;3319;3291;3275;1898;1892;1878;1863;1612;1642;1670;1685;
2611042;"Pawłów (2)";15381;15394;15332;15312;3262;3183;3150;3086;9491;9550;9520;9516;6212;6251;6189;6174;3279;3299;3331;3342;2628;2661;2662;2710;
2611053;"Wąchock (3)";7126;7064;7014;6947;1165;1142;1100;1060;4416;4385;4343;4295;2621;2625;2603;2581;1795;1760;1740;1714;1545;1537;1571;1592;
2611054;"Wąchock - miasto (4)";2889;2865;2848;2809;439;432;418;400;1817;1808;1778;1745;1048;1047;1031;1019;769;761;747;726;633;625;652;664;
2611055;"Wąchock - obszar wiejski (5)";4237;4199;4166;4138;726;710;682;660;2599;2577;2565;2550;1573;1578;1572;1562;1026;999;993;988;912;912;919;928;
2612012;"Bogoria (2)";7961;7933;7895;7892;1670;1639;1583;1560;4835;4822;4812;4809;3072;3045;3050;3053;1763;1777;1762;1756;1456;1472;1500;1523;
2612022;"Łubnice (2)";4306;4247;4222;4118;804;751;723;696;2569;2544;2546;2477;1578;1564;1566;1522;991;980;980;955;933;952;953;945;
2612032;"Oleśnica (2)";3928;3907;3897;3908;747;701;693;695;2427;2452;2466;2459;1522;1549;1543;1540;905;903;923;919;754;754;738;754;
2612043;"Osiek (3)";7841;7819;7832;7804;1581;1551;1523;1512;4808;4788;4824;4799;3102;3106;3108;3072;1706;1682;1716;1727;1452;1480;1485;1493;
2612044;"Osiek - miasto (4)";1990;2004;2013;1998;376;380;367;371;1256;1262;1281;1265;783;786;797;780;473;476;484;485;358;362;365;362;
2612045;"Osiek - obszar wiejski (5)";5851;5815;5819;5806;1205;1171;1156;1141;3552;3526;3543;3534;2319;2320;2311;2292;1233;1206;1232;1242;1094;1118;1120;1131;
2612053;"Połaniec (3)";11991;11989;11968;11990;2271;2220;2193;2164;8256;8221;8133;8075;4854;4873;4823;4819;3402;3348;3310;3256;1464;1548;1642;1751;
2612054;"Połaniec - miasto (4)";8328;8347;8279;8275;1534;1512;1472;1453;5946;5902;5787;5700;3394;3405;3350;3339;2552;2497;2437;2361;848;933;1020;1122;
2612055;"Połaniec - obszar wiejski (5)";3663;3642;3689;3715;737;708;721;711;2310;2319;2346;2375;1460;1468;1473;1480;850;851;873;895;616;615;622;629;
2612062;"Rytwiany (2)";6448;6392;6358;6343;1279;1220;1163;1142;4003;3994;3992;3957;2521;2530;2544;2530;1482;1464;1448;1427;1166;1178;1203;1244;
2612073;"Staszów (3)";26582;26436;26369;26193;4879;4703;4617;4527;16827;16672;16522;16238;10456;10441;10366;10172;6371;6231;6156;6066;4876;5061;5230;5428;
2612074;"Staszów - miasto (4)";15517;15384;15298;15152;2768;2661;2602;2515;9983;9800;9643;9449;6107;6048;5963;5793;3876;3752;3680;3656;2766;2923;3053;3188;
2612075;"Staszów - obszar wiejski (5)";11065;11052;11071;11041;2111;2042;2015;2012;6844;6872;6879;6789;4349;4393;4403;4379;2495;2479;2476;2410;2110;2138;2177;2240;
2612082;"Szydłów (2)";4801;4782;4779;4788;813;783;775;795;3044;3031;3025;3004;1818;1817;1804;1800;1226;1214;1221;1204;944;968;979;989;
2613012;"Kluczewsko (2)";5265;5252;5260;5238;1075;1039;1049;1003;3225;3229;3229;3248;2073;2088;2074;2079;1152;1141;1155;1169;965;984;982;987;
2613022;"Krasocin (2)";10805;10819;10768;10733;2181;2166;2132;2109;6751;6771;6711;6659;4365;4364;4347;4291;2386;2407;2364;2368;1873;1882;1925;1965;
2613032;"Moskorzew (2)";2747;2755;2760;2770;443;443;447;439;1662;1659;1658;1655;1000;1015;1018;1035;662;644;640;620;642;653;655;676;
2613042;"Radków (2)";2568;2573;2539;2546;410;401;400;398;1536;1548;1499;1493;894;893;856;884;642;655;643;609;622;624;640;655;
2613052;"Secemin (2)";4950;4914;4918;4879;834;802;789;791;2990;2967;2968;2936;1787;1769;1785;1774;1203;1198;1183;1162;1126;1145;1161;1152;
2613063;"Włoszczowa (3)";20185;20008;19901;19755;3746;3608;3480;3413;12769;12589;12498;12320;7874;7796;7780;7665;4895;4793;4718;4655;3670;3811;3923;4022;
2613064;"Włoszczowa - miasto (4)";10675;10545;10417;10269;1895;1829;1721;1675;6934;6765;6666;6468;4160;4068;4030;3909;2774;2697;2636;2559;1846;1951;2030;2126;
2613065;"Włoszczowa - obszar wiejski (5)";9510;9463;9484;9486;1851;1779;1759;1738;5835;5824;5832;5852;3714;3728;3750;3756;2121;2096;2082;2096;1824;1860;1893;1896;
2661011;"Kielce (1)";200938;199870;198857;198046;31410;31168;30890;30773;127913;125513;123181;121015;78790;77824;76817;75900;49123;47689;46364;45115;41615;43189;44786;46258;
2801011;"Bartoszyce (1)";24719;24527;24432;24196;4295;4224;4182;4109;16149;15836;15570;15191;9620;9533;9450;9214;6529;6303;6120;5977;4275;4467;4680;4896;
2801021;"Górowo Iławeckie (1)";4350;4264;4198;4140;722;711;700;677;2851;2759;2674;2615;1686;1635;1605;1572;1165;1124;1069;1043;777;794;824;848;
2801032;"Bartoszyce (2)";11063;11072;11002;11004;2261;2192;2167;2132;7266;7314;7232;7222;4605;4654;4592;4558;2661;2660;2640;2664;1536;1566;1603;1650;
2801043;"Bisztynek (3)";6748;6688;6620;6529;1266;1218;1181;1147;4397;4362;4321;4234;2659;2653;2643;2604;1738;1709;1678;1630;1085;1108;1118;1148;
2801044;"Bisztynek - miasto (4)";2524;2492;2477;2437;428;418;397;389;1720;1681;1676;1638;1012;997;1009;981;708;684;667;657;376;393;404;410;
2801045;"Bisztynek - obszar wiejski (5)";4224;4196;4143;4092;838;800;784;758;2677;2681;2645;2596;1647;1656;1634;1623;1030;1025;1011;973;709;715;714;738;
2801052;"Górowo Iławeckie (2)";7126;7066;7036;7019;1453;1405;1398;1347;4627;4588;4528;4533;2906;2892;2876;2866;1721;1696;1652;1667;1046;1073;1110;1139;
2801063;"Sępopol (3)";6689;6588;6542;6490;1238;1201;1158;1154;4333;4252;4215;4135;2592;2546;2524;2500;1741;1706;1691;1635;1118;1135;1169;1201;
2801064;"Sępopol - miasto (4)";2093;2051;2013;2024;350;341;325;327;1367;1312;1283;1285;772;746;720;735;595;566;563;550;376;398;405;412;
2801065;"Sępopol - obszar wiejski (5)";4596;4537;4529;4466;888;860;833;827;2966;2940;2932;2850;1820;1800;1804;1765;1146;1140;1128;1085;742;737;764;789;
2802011;"Braniewo (1)";17455;17385;17281;17161;3220;3194;3115;3011;11567;11422;11266;11104;7188;7120;7047;6959;4379;4302;4219;4145;2668;2769;2900;3046;
2802022;"Braniewo (2)";6344;6261;6216;6214;1397;1330;1273;1232;4161;4135;4129;4142;2618;2599;2585;2616;1543;1536;1544;1526;786;796;814;840;
2802033;"Frombork (3)";3731;3744;3719;3726;655;652;611;613;2464;2474;2462;2433;1533;1534;1550;1532;931;940;912;901;612;618;646;680;
2802034;"Frombork - miasto (4)";2458;2475;2437;2446;397;401;368;371;1650;1654;1623;1595;991;991;985;977;659;663;638;618;411;420;446;480;
2802035;"Frombork - obszar wiejski (5)";1273;1269;1282;1280;258;251;243;242;814;820;839;838;542;543;565;555;272;277;274;283;201;198;200;200;
2802042;"Lelkowo (2)";3078;3022;3035;3009;585;521;519;502;1997;1999;2000;1992;1253;1249;1252;1231;744;750;748;761;496;502;516;515;
2802053;"Pieniężno (3)";6662;6639;6543;6464;1159;1124;1076;1045;4445;4418;4344;4279;2564;2557;2509;2461;1881;1861;1835;1818;1058;1097;1123;1140;
2802054;"Pieniężno - miasto (4)";2952;2949;2909;2863;464;452;438;417;2055;2029;1977;1931;1154;1165;1141;1110;901;864;836;821;433;468;494;515;
2802055;"Pieniężno - obszar wiejski (5)";3710;3690;3634;3601;695;672;638;628;2390;2389;2367;2348;1410;1392;1368;1351;980;997;999;997;625;629;629;625;
2802062;"Płoskinia (2)";2610;2581;2581;2551;578;553;549;528;1659;1637;1627;1615;1072;1070;1059;1041;587;567;568;574;373;391;405;408;
2802072;"Wilczęta (2)";3143;3108;3094;3083;628;605;589;586;2025;2003;1996;1984;1269;1261;1263;1261;756;742;733;723;490;500;509;513;
2803011;"Działdowo (1)";21589;21552;21489;21402;4027;4019;3919;3815;14325;14123;13919;13766;8782;8649;8613;8531;5543;5474;5306;5235;3237;3410;3651;3821;
2803022;"Działdowo (2)";9809;9836;9823;9871;2313;2313;2285;2278;6188;6185;6188;6227;3991;3976;3965;3989;2197;2209;2223;2238;1308;1338;1350;1366;
2803032;"Iłowo-Osada (2)";7356;7308;7330;7321;1647;1593;1575;1526;4570;4556;4562;4568;2940;2940;2923;2916;1630;1616;1639;1652;1139;1159;1193;1227;
2803043;"Lidzbark (3)";14704;14640;14549;14444;3024;2928;2872;2808;9341;9316;9186;9100;5832;5802;5722;5608;3509;3514;3464;3492;2339;2396;2491;2536;
2803044;"Lidzbark - miasto (4)";8228;8168;8092;8002;1561;1522;1494;1444;5315;5242;5126;5025;3193;3151;3095;3000;2122;2091;2031;2025;1352;1404;1472;1533;
2803045;"Lidzbark - obszar wiejski (5)";6476;6472;6457;6442;1463;1406;1378;1364;4026;4074;4060;4075;2639;2651;2627;2608;1387;1423;1433;1467;987;992;1019;1003;
2803052;"Płośnica (2)";5907;5875;5812;5763;1279;1255;1231;1178;3651;3636;3588;3564;2288;2280;2232;2207;1363;1356;1356;1357;977;984;993;1021;
2803062;"Rybno (2)";7347;7274;7283;7312;1670;1610;1587;1543;4669;4633;4636;4667;3004;2984;2989;3007;1665;1649;1647;1660;1008;1031;1060;1102;
2804012;"Elbląg (2)";7216;7208;7266;7439;1543;1538;1521;1529;4831;4780;4822;4911;3039;2994;3003;3091;1792;1786;1819;1820;842;890;923;999;
2804022;"Godkowo (2)";3280;3246;3225;3186;666;652;637;616;2046;2022;2008;1985;1280;1275;1256;1242;766;747;752;743;568;572;580;585;
2804032;"Gronowo Elbląskie (2)";5178;5181;5180;5167;1124;1089;1072;1070;3455;3452;3437;3398;2186;2181;2171;2142;1269;1271;1266;1256;599;640;671;699;
2804042;"Markusy (2)";4206;4210;4197;4182;1026;1010;971;936;2657;2677;2685;2681;1731;1739;1740;1745;926;938;945;936;523;523;541;565;
2804052;"Milejewo (2)";3274;3299;3330;3370;690;697;681;700;2201;2217;2243;2241;1407;1410;1426;1426;794;807;817;815;383;385;406;429;
2804063;"Młynary (3)";4586;4548;4528;4518;1008;960;923;899;2901;2890;2880;2873;1817;1805;1795;1789;1084;1085;1085;1084;677;698;725;746;
2804064;"Młynary - miasto (4)";1848;1831;1817;1806;396;375;368;350;1191;1184;1161;1160;761;754;728;723;430;430;433;437;261;272;288;296;
2804065;"Młynary - obszar wiejski (5)";2738;2717;2711;2712;612;585;555;549;1710;1706;1719;1713;1056;1051;1067;1066;654;655;652;647;416;426;437;450;
2804073;"Pasłęk (3)";19747;19696;19653;19590;3842;3819;3802;3726;12868;12721;12601;12449;7965;7905;7838;7804;4903;4816;4763;4645;3037;3156;3250;3415;
2804074;"Pasłęk - miasto (4)";12421;12453;12406;12373;2218;2253;2224;2214;8141;8029;7924;7772;4885;4851;4818;4777;3256;3178;3106;2995;2062;2171;2258;2387;
2804075;"Pasłęk - obszar wiejski (5)";7326;7243;7247;7217;1624;1566;1578;1512;4727;4692;4677;4677;3080;3054;3020;3027;1647;1638;1657;1650;975;985;992;1028;
2804082;"Rychliki (2)";4057;4032;3959;3922;855;844;797;765;2590;2574;2511;2487;1606;1593;1555;1546;984;981;956;941;612;614;651;670;
2804093;"Tolkmicko (3)";6858;6840;6836;6846;1398;1332;1311;1339;4398;4397;4379;4331;2688;2671;2692;2665;1710;1726;1687;1666;1062;1111;1146;1176;
2804094;"Tolkmicko - miasto (4)";2792;2807;2794;2739;513;499;491;479;1787;1787;1784;1743;1067;1053;1056;1033;720;734;728;710;492;521;519;517;
2804095;"Tolkmicko - obszar wiejski (5)";4066;4033;4042;4107;885;833;820;860;2611;2610;2595;2588;1621;1618;1636;1632;990;992;959;956;570;590;627;659;
2805011;"Ełk (1)";59646;59790;60103;60462;11691;11753;11726;11777;39380;39005;38857;38721;25207;25014;24986;25008;14173;13991;13871;13713;8575;9032;9520;9964;
2805022;"Ełk (2)";11071;11147;11270;11270;2380;2339;2338;2295;7184;7269;7342;7344;4543;4557;4594;4563;2641;2712;2748;2781;1507;1539;1590;1631;
2805032;"Kalinowo (2)";7071;7064;7030;6992;1599;1530;1498;1429;4472;4552;4528;4511;2890;2944;2919;2928;1582;1608;1609;1583;1000;982;1004;1052;
2805042;"Prostki (2)";7538;7519;7505;7459;1705;1656;1611;1572;4811;4813;4820;4812;3136;3124;3131;3138;1675;1689;1689;1674;1022;1050;1074;1075;
2805052;"Stare Juchy (2)";3959;3957;3975;3897;857;813;809;760;2464;2503;2516;2472;1609;1650;1653;1611;855;853;863;861;638;641;650;665;
2806011;"Giżycko (1)";30096;29947;29932;29726;5241;5175;5144;5012;19346;18976;18752;18474;11676;11511;11402;11305;7670;7465;7350;7169;5509;5796;6036;6240;
2806042;"Giżycko (2)";8147;8246;8276;8301;1638;1602;1570;1568;5467;5562;5579;5516;3242;3284;3306;3293;2225;2278;2273;2223;1042;1082;1127;1217;
2806052;"Kruklanki (2)";3178;3152;3154;3137;666;639;625;610;2055;2050;2070;2038;1291;1292;1304;1299;764;758;766;739;457;463;459;489;
2806062;"Miłki (2)";3876;3842;3844;3853;793;785;757;764;2518;2480;2488;2462;1581;1539;1575;1568;937;941;913;894;565;577;599;627;
2806083;"Ryn (3)";5898;5885;5853;5846;1108;1077;1057;1033;3870;3851;3828;3819;2342;2338;2307;2292;1528;1513;1521;1527;920;957;968;994;
2806084;"Ryn - miasto (4)";2948;2925;2910;2899;511;500;498;481;1975;1937;1920;1911;1164;1144;1118;1111;811;793;802;800;462;488;492;507;
2806085;"Ryn - obszar wiejski (5)";2950;2960;2943;2947;597;577;559;552;1895;1914;1908;1908;1178;1194;1189;1181;717;720;719;727;458;469;476;487;
2806102;"Wydminy (2)";6570;6544;6503;6423;1317;1279;1229;1200;4174;4171;4145;4072;2630;2638;2631;2592;1544;1533;1514;1480;1079;1094;1129;1151;
2807011;"Iława (1)";33360;33338;33344;33174;6048;6009;5951;5821;21529;21262;20983;20634;12933;12843;12739;12582;8596;8419;8244;8052;5783;6067;6410;6719;
2807021;"Lubawa (1)";10059;10093;10098;10083;2176;2185;2169;2158;6398;6361;6310;6243;4145;4126;4075;4042;2253;2235;2235;2201;1485;1547;1619;1682;
2807032;"Iława (2)";12809;12855;12884;12874;3058;3013;2974;2878;8303;8372;8391;8381;5475;5498;5508;5518;2828;2874;2883;2863;1448;1470;1519;1615;
2807043;"Kisielice (3)";6203;6137;6079;6055;1347;1302;1262;1247;4046;3996;3924;3882;2538;2486;2457;2454;1508;1510;1467;1428;810;839;893;926;
2807044;"Kisielice - miasto (4)";2189;2155;2131;2122;401;386;369;365;1498;1466;1429;1410;879;848;829;832;619;618;600;578;290;303;333;347;
2807045;"Kisielice - obszar wiejski (5)";4014;3982;3948;3933;946;916;893;882;2548;2530;2495;2472;1659;1638;1628;1622;889;892;867;850;520;536;560;579;
2807052;"Lubawa (2)";10621;10619;10632;10670;2593;2541;2462;2454;6596;6618;6670;6680;4391;4388;4433;4444;2205;2230;2237;2236;1432;1460;1500;1536;
2807063;"Susz (3)";13095;13064;13038;12992;2901;2850;2813;2771;8486;8455;8429;8324;5437;5404;5413;5338;3049;3051;3016;2986;1708;1759;1796;1897;
2807064;"Susz - miasto (4)";5728;5717;5694;5654;1092;1074;1062;1050;3804;3770;3740;3659;2380;2355;2354;2300;1424;1415;1386;1359;832;873;892;945;
2807065;"Susz - obszar wiejski (5)";7367;7347;7344;7338;1809;1776;1751;1721;4682;4685;4689;4665;3057;3049;3059;3038;1625;1636;1630;1627;876;886;904;952;
2807073;"Zalewo (3)";7054;7028;6977;6947;1454;1381;1351;1309;4525;4540;4499;4468;2803;2838;2806;2823;1722;1702;1693;1645;1075;1107;1127;1170;
2807074;"Zalewo - miasto (4)";2222;2211;2185;2186;375;360;348;348;1508;1497;1474;1455;900;902;890;889;608;595;584;566;339;354;363;383;
2807075;"Zalewo - obszar wiejski (5)";4832;4817;4792;4761;1079;1021;1003;961;3017;3043;3025;3013;1903;1936;1916;1934;1114;1107;1109;1079;736;753;764;787;
2808011;"Kętrzyn (1)";28256;28051;27924;27732;4577;4481;4455;4440;18419;18136;17816;17368;10919;10823;10721;10500;7500;7313;7095;6868;5260;5434;5653;5924;
2808022;"Barciany (2)";6758;6671;6580;6507;1350;1280;1235;1198;4355;4320;4252;4205;2674;2648;2617;2583;1681;1672;1635;1622;1053;1071;1093;1104;
2808032;"Kętrzyn (2)";8472;8439;8466;8438;1787;1777;1768;1736;5529;5509;5493;5465;3464;3434;3433;3418;2065;2075;2060;2047;1156;1153;1205;1237;
2808043;"Korsze (3)";10473;10388;10267;10127;2055;1990;1923;1845;6878;6840;6759;6652;4262;4236;4171;4109;2616;2604;2588;2543;1540;1558;1585;1630;
2808044;"Korsze - miasto (4)";4600;4586;4514;4408;778;771;743;697;3018;3007;2963;2872;1802;1794;1770;1717;1216;1213;1193;1155;804;808;808;839;
2808045;"Korsze - obszar wiejski (5)";5873;5802;5753;5719;1277;1219;1180;1148;3860;3833;3796;3780;2460;2442;2401;2392;1400;1391;1395;1388;736;750;777;791;
2808053;"Reszel (3)";8088;7968;7834;7702;1353;1308;1244;1195;5249;5120;5001;4872;3099;3021;2942;2876;2150;2099;2059;1996;1486;1540;1589;1635;
2808054;"Reszel - miasto (4)";4896;4817;4753;4667;745;718;688;653;3186;3097;3027;2939;1861;1809;1761;1722;1325;1288;1266;1217;965;1002;1038;1075;
2808055;"Reszel - obszar wiejski (5)";3192;3151;3081;3035;608;590;556;542;2063;2023;1974;1933;1238;1212;1181;1154;825;811;793;779;521;538;551;560;
2808062;"Srokowo (2)";4061;3992;3969;3944;744;709;701;687;2693;2646;2617;2588;1622;1583;1581;1575;1071;1063;1036;1013;624;637;651;669;
2809011;"Lidzbark Warmiński (1)";16539;16352;16332;16200;2869;2805;2826;2756;10672;10458;10302;10119;6436;6291;6228;6157;4236;4167;4074;3962;2998;3089;3204;3325;
2809022;"Kiwity (2)";3417;3355;3338;3335;653;597;575;580;2244;2226;2224;2197;1433;1417;1414;1394;811;809;810;803;520;532;539;558;
2809032;"Lidzbark Warmiński (2)";6804;6815;6771;6771;1386;1367;1297;1304;4476;4497;4493;4460;2823;2849;2834;2813;1653;1648;1659;1647;942;951;981;1007;
2809042;"Lubomino (2)";3659;3651;3668;3634;788;760;757;755;2348;2350;2350;2314;1487;1497;1491;1477;861;853;859;837;523;541;561;565;
2809053;"Orneta (3)";12546;12409;12397;12326;2323;2299;2258;2203;8077;7915;7890;7790;4994;4911;4915;4857;3083;3004;2975;2933;2146;2195;2249;2333;
2809054;"Orneta - miasto (4)";9169;9046;9057;9008;1628;1596;1585;1558;5887;5754;5707;5614;3616;3552;3543;3495;2271;2202;2164;2119;1654;1696;1765;1836;
2809055;"Orneta - obszar wiejski (5)";3377;3363;3340;3318;695;703;673;645;2190;2161;2183;2176;1378;1359;1372;1362;812;802;811;814;492;499;484;497;
2810011;"Mrągowo (1)";22251;22190;22135;22005;3930;3886;3834;3782;14662;14467;14302;14067;8720;8628;8594;8475;5942;5839;5708;5592;3659;3837;3999;4156;
2810023;"Mikołajki (3)";8465;8403;8348;8305;1584;1543;1486;1459;5506;5438;5393;5340;3346;3288;3259;3227;2160;2150;2134;2113;1375;1422;1469;1506;
2810024;"Mikołajki - miasto (4)";3911;3883;3849;3827;666;644;627;598;2548;2524;2478;2458;1474;1448;1422;1413;1074;1076;1056;1045;697;715;744;771;
2810025;"Mikołajki - obszar wiejski (5)";4554;4520;4499;4478;918;899;859;861;2958;2914;2915;2882;1872;1840;1837;1814;1086;1074;1078;1068;678;707;725;735;
2810032;"Mrągowo (2)";7956;7946;7979;7974;1702;1631;1598;1546;5219;5254;5281;5283;3244;3265;3272;3275;1975;1989;2009;2008;1035;1061;1100;1145;
2810042;"Piecki (2)";7914;7818;7755;7758;1665;1582;1526;1489;5214;5180;5139;5128;3292;3268;3241;3237;1922;1912;1898;1891;1035;1056;1090;1141;
2810052;"Sorkwity (2)";4727;4712;4684;4654;1057;1033;1014;1000;3046;3049;3027;3002;1956;1952;1929;1891;1090;1097;1098;1111;624;630;643;652;
2811012;"Janowiec Kościelny (2)";3387;3339;3320;3277;752;712;707;672;2063;2051;2018;2005;1327;1309;1293;1275;736;742;725;730;572;576;595;600;
2811022;"Janowo (2)";2838;2803;2788;2730;633;607;599;558;1724;1712;1696;1669;1059;1058;1040;1010;665;654;656;659;481;484;493;503;
2811032;"Kozłowo (2)";6300;6260;6230;6186;1479;1432;1406;1342;4035;4014;3982;3984;2649;2643;2609;2578;1386;1371;1373;1406;786;814;842;860;
2811043;"Nidzica (3)";21608;21501;21521;21465;4178;4060;3982;3880;14107;14027;13945;13845;8723;8670;8675;8640;5384;5357;5270;5205;3323;3414;3594;3740;
2811044;"Nidzica - miasto (4)";14395;14300;14258;14166;2531;2459;2416;2350;9483;9375;9229;9084;5728;5655;5612;5551;3755;3720;3617;3533;2381;2466;2613;2732;
2811045;"Nidzica - obszar wiejski (5)";7213;7201;7263;7299;1647;1601;1566;1530;4624;4652;4716;4761;2995;3015;3063;3089;1629;1637;1653;1672;942;948;981;1008;
2812011;"Nowe Miasto Lubawskie (1)";11224;11241;11180;11101;2248;2222;2149;2094;7041;7043;6991;6893;4384;4372;4354;4292;2657;2671;2637;2601;1935;1976;2040;2114;
2812022;"Biskupiec (2)";9603;9546;9523;9538;2175;2107;2021;1987;5994;6001;6024;6030;3854;3843;3859;3862;2140;2158;2165;2168;1434;1438;1478;1521;
2812032;"Grodziczno (2)";6363;6371;6386;6383;1520;1484;1488;1467;3871;3893;3873;3882;2471;2482;2469;2492;1400;1411;1404;1390;972;994;1025;1034;
2812042;"Kurzętnik (2)";9080;9043;9094;9127;2094;2052;2062;2059;5682;5626;5609;5598;3676;3667;3666;3667;2006;1959;1943;1931;1304;1365;1423;1470;
2812052;"Nowe Miasto Lubawskie (2)";8003;8064;8108;8172;1840;1823;1808;1815;5053;5116;5139;5147;3316;3337;3368;3361;1737;1779;1771;1786;1110;1125;1161;1210;
2813032;"Kowale Oleckie (2)";5333;5286;5266;5218;1114;1065;1045;1015;3390;3372;3363;3321;2148;2155;2149;2127;1242;1217;1214;1194;829;849;858;882;
2813043;"Olecko (3)";22213;22196;22091;22078;4445;4425;4353;4344;14236;14075;13914;13770;8909;8801;8787;8746;5327;5274;5127;5024;3532;3696;3824;3964;
2813044;"Olecko - miasto (4)";16556;16533;16458;16460;3119;3138;3083;3100;10685;10509;10381;10231;6580;6472;6485;6461;4105;4037;3896;3770;2752;2886;2994;3129;
2813045;"Olecko - obszar wiejski (5)";5657;5663;5633;5618;1326;1287;1270;1244;3551;3566;3533;3539;2329;2329;2302;2285;1222;1237;1231;1254;780;810;830;835;
2813052;"Świętajno (2)";3994;4023;4034;4052;820;788;768;751;2611;2651;2663;2682;1605;1643;1671;1700;1006;1008;992;982;563;584;603;619;
2813062;"Wieliczki (2)";3419;3382;3414;3397;764;722;704;679;2165;2170;2213;2194;1395;1387;1421;1405;770;783;792;789;490;490;497;524;
2814013;"Barczewo (3)";17339;17358;17465;17550;3531;3477;3421;3375;11431;11396;11437;11449;7199;7206;7220;7273;4232;4190;4217;4176;2377;2485;2607;2726;
2814014;"Barczewo - miasto (4)";7320;7265;7280;7290;1379;1346;1305;1285;4694;4628;4606;4581;2933;2918;2936;2949;1761;1710;1670;1632;1247;1291;1369;1424;
2814015;"Barczewo - obszar wiejski (5)";10019;10093;10185;10260;2152;2131;2116;2090;6737;6768;6831;6868;4266;4288;4284;4324;2471;2480;2547;2544;1130;1194;1238;1302;
2814023;"Biskupiec (3)";19324;19187;19157;19091;3554;3479;3444;3416;12878;12694;12581;12403;7913;7806;7702;7601;4965;4888;4879;4802;2892;3014;3132;3272;
2814024;"Biskupiec - miasto (4)";10669;10626;10600;10582;1773;1765;1751;1755;7080;6944;6843;6735;4243;4193;4119;4095;2837;2751;2724;2640;1816;1917;2006;2092;
2814025;"Biskupiec - obszar wiejski (5)";8655;8561;8557;8509;1781;1714;1693;1661;5798;5750;5738;5668;3670;3613;3583;3506;2128;2137;2155;2162;1076;1097;1126;1180;
2814033;"Dobre Miasto (3)";16183;16179;16161;16124;3085;3072;3037;2996;10533;10419;10318;10206;6524;6494;6485;6460;4009;3925;3833;3746;2565;2688;2806;2922;
2814034;"Dobre Miasto - miasto (4)";10661;10599;10497;10471;1923;1898;1849;1840;6874;6730;6591;6490;4182;4141;4096;4073;2692;2589;2495;2417;1864;1971;2057;2141;
2814035;"Dobre Miasto - obszar wiejski (5)";5522;5580;5664;5653;1162;1174;1188;1156;3659;3689;3727;3716;2342;2353;2389;2387;1317;1336;1338;1329;701;717;749;781;
2814042;"Dywity (2)";10791;11011;11097;11253;2286;2350;2313;2304;7264;7335;7353;7382;4517;4589;4589;4631;2747;2746;2764;2751;1241;1326;1431;1567;
2814052;"Gietrzwałd (2)";6191;6348;6485;6522;1287;1313;1323;1317;4148;4215;4281;4279;2548;2608;2656;2668;1600;1607;1625;1611;756;820;881;926;
2814063;"Jeziorany (3)";8012;7995;7952;7939;1582;1524;1478;1455;5259;5270;5221;5186;3251;3285;3262;3241;2008;1985;1959;1945;1171;1201;1253;1298;
2814064;"Jeziorany - miasto (4)";3333;3346;3319;3312;614;601;591;580;2206;2195;2159;2136;1334;1345;1327;1320;872;850;832;816;513;550;569;596;
2814065;"Jeziorany - obszar wiejski (5)";4679;4649;4633;4627;968;923;887;875;3053;3075;3062;3050;1917;1940;1935;1921;1136;1135;1127;1129;658;651;684;702;
2814072;"Jonkowo (2)";6877;7014;7090;7108;1530;1554;1520;1480;4572;4620;4677;4701;2917;2962;2999;2979;1655;1658;1678;1722;775;840;893;927;
2814082;"Kolno (2)";3385;3332;3292;3300;622;602;581;577;2214;2181;2163;2157;1354;1317;1307;1303;860;864;856;854;549;549;548;566;
2814093;"Olsztynek (3)";13960;13989;14007;13876;2783;2754;2706;2654;9170;9129;9123;9000;5684;5632;5623;5544;3486;3497;3500;3456;2007;2106;2178;2222;
2814094;"Olsztynek - miasto (4)";7725;7721;7738;7669;1428;1433;1412;1377;5130;5066;5052;4982;3085;3033;3037;3006;2045;2033;2015;1976;1167;1222;1274;1310;
2814095;"Olsztynek - obszar wiejski (5)";6235;6268;6269;6207;1355;1321;1294;1277;4040;4063;4071;4018;2599;2599;2586;2538;1441;1464;1485;1480;840;884;904;912;
2814102;"Purda (2)";8335;8463;8507;8563;1652;1662;1646;1630;5723;5792;5790;5766;3558;3591;3592;3584;2165;2201;2198;2182;960;1009;1071;1167;
2814112;"Stawiguda (2)";7105;7398;7656;7975;1478;1544;1604;1690;4862;5007;5152;5298;3170;3304;3425;3521;1692;1703;1727;1777;765;847;900;987;
2814122;"Świątki (2)";4208;4209;4180;4178;911;883;863;854;2721;2749;2728;2719;1754;1784;1763;1755;967;965;965;964;576;577;589;605;
2815011;"Ostróda (1)";34047;33963;33790;33517;6099;6039;6011;5843;21827;21536;21171;20774;13140;13112;12938;12734;8687;8424;8233;8040;6121;6388;6608;6900;
2815022;"Dąbrówno (2)";4517;4468;4443;4405;972;924;903;886;2864;2849;2812;2784;1762;1758;1733;1698;1102;1091;1079;1086;681;695;728;735;
2815032;"Grunwald (2)";5812;5756;5771;5782;1354;1304;1293;1290;3694;3685;3684;3684;2357;2357;2374;2373;1337;1328;1310;1311;764;767;794;808;
2815042;"Łukta (2)";4536;4544;4550;4512;998;972;959;929;2947;2964;2963;2946;1875;1892;1868;1844;1072;1072;1095;1102;591;608;628;637;
2815052;"Małdyty (2)";6514;6431;6409;6370;1338;1261;1218;1191;4222;4189;4182;4113;2585;2561;2583;2573;1637;1628;1599;1540;954;981;1009;1066;
2815063;"Miłakowo (3)";5762;5692;5639;5629;1180;1137;1092;1101;3754;3706;3661;3602;2356;2325;2302;2270;1398;1381;1359;1332;828;849;886;926;
2815064;"Miłakowo - miasto (4)";2675;2653;2632;2631;502;484;456;459;1713;1701;1681;1661;1044;1032;1025;1012;669;669;656;649;460;468;495;511;
2815065;"Miłakowo - obszar wiejski (5)";3087;3039;3007;2998;678;653;636;642;2041;2005;1980;1941;1312;1293;1277;1258;729;712;703;683;368;381;391;415;
2815073;"Miłomłyn (3)";5071;5085;5073;5042;1002;1003;984;956;3271;3263;3266;3249;2020;2021;2012;2007;1251;1242;1254;1242;798;819;823;837;
2815074;"Miłomłyn - miasto (4)";2417;2431;2444;2434;479;485;481;456;1570;1566;1575;1579;961;962;964;966;609;604;611;613;368;380;388;399;
2815075;"Miłomłyn - obszar wiejski (5)";2654;2654;2629;2608;523;518;503;500;1701;1697;1691;1670;1059;1059;1048;1041;642;638;643;629;430;439;435;438;
2815083;"Morąg (3)";25061;24967;24868;24768;5017;4922;4818;4739;16212;16066;15892;15666;10139;10117;10059;9988;6073;5949;5833;5678;3832;3979;4158;4363;
2815084;"Morąg - miasto (4)";14458;14361;14269;14110;2648;2598;2521;2445;9407;9246;9091;8852;5799;5760;5701;5614;3608;3486;3390;3238;2403;2517;2657;2813;
2815085;"Morąg - obszar wiejski (5)";10603;10606;10599;10658;2369;2324;2297;2294;6805;6820;6801;6814;4340;4357;4358;4374;2465;2463;2443;2440;1429;1462;1501;1550;
2815092;"Ostróda (2)";15858;15821;15899;15998;3442;3365;3307;3295;10230;10255;10347;10379;6562;6544;6596;6616;3668;3711;3751;3763;2186;2201;2245;2324;
2816013;"Biała Piska (3)";12230;12119;12093;12017;2668;2557;2509;2436;7835;7803;7774;7735;5101;5068;5034;4977;2734;2735;2740;2758;1727;1759;1810;1846;
2816014;"Biała Piska - miasto (4)";4114;4125;4124;4120;757;757;751;744;2725;2712;2699;2683;1707;1687;1686;1670;1018;1025;1013;1013;632;656;674;693;
2816015;"Biała Piska - obszar wiejski (5)";8116;7994;7969;7897;1911;1800;1758;1692;5110;5091;5075;5052;3394;3381;3348;3307;1716;1710;1727;1745;1095;1103;1136;1153;
2816023;"Orzysz (3)";9476;9375;9360;9276;1895;1778;1741;1746;6075;6071;6037;5905;3840;3855;3854;3774;2235;2216;2183;2131;1506;1526;1582;1625;
2816024;"Orzysz - miasto (4)";5833;5797;5799;5726;1122;1081;1068;1072;3783;3769;3750;3633;2388;2409;2415;2339;1395;1360;1335;1294;928;947;981;1021;
2816025;"Orzysz - obszar wiejski (5)";3643;3578;3561;3550;773;697;673;674;2292;2302;2287;2272;1452;1446;1439;1435;840;856;848;837;578;579;601;604;
2816033;"Pisz (3)";27942;27953;27968;27956;5688;5630;5551;5477;17996;17927;17855;17770;11554;11478;11386;11322;6442;6449;6469;6448;4258;4396;4562;4709;
2816034;"Pisz - miasto (4)";19547;19530;19562;19489;3685;3670;3657;3577;12640;12532;12436;12332;8031;7950;7879;7840;4609;4582;4557;4492;3222;3328;3469;3580;
2816035;"Pisz - obszar wiejski (5)";8395;8423;8406;8467;2003;1960;1894;1900;5356;5395;5419;5438;3523;3528;3507;3482;1833;1867;1912;1956;1036;1068;1093;1129;
2816043;"Ruciane-Nida (3)";8439;8372;8350;8321;1419;1395;1352;1348;5552;5486;5444;5381;3387;3322;3291;3197;2165;2164;2153;2184;1468;1491;1554;1592;
2816044;"Ruciane-Nida - miasto (4)";4752;4701;4674;4632;721;719;697;691;3132;3067;3024;2953;1848;1795;1766;1704;1284;1272;1258;1249;899;915;953;988;
2816045;"Ruciane-Nida - obszar wiejski (5)";3687;3671;3676;3689;698;676;655;657;2420;2419;2420;2428;1539;1527;1525;1493;881;892;895;935;569;576;601;604;
2817011;"Szczytno (1)";24805;24489;24185;23992;4230;4155;3991;3897;16075;15688;15378;15072;9680;9491;9350;9230;6395;6197;6028;5842;4500;4646;4816;5023;
2817022;"Dźwierzuty (2)";6857;6787;6768;6686;1492;1395;1350;1302;4384;4398;4401;4338;2838;2827;2818;2769;1546;1571;1583;1569;981;994;1017;1046;
2817032;"Jedwabno (2)";3716;3704;3715;3684;806;777;769;748;2389;2402;2406;2381;1523;1530;1539;1508;866;872;867;873;521;525;540;555;
2817043;"Pasym (3)";5410;5410;5386;5392;1133;1112;1070;1065;3570;3552;3534;3514;2179;2163;2149;2144;1391;1389;1385;1370;707;746;782;813;
2817044;"Pasym - miasto (4)";2542;2536;2542;2561;480;478;473;478;1701;1666;1658;1649;1008;990;982;992;693;676;676;657;361;392;411;434;
2817045;"Pasym - obszar wiejski (5)";2868;2874;2844;2831;653;634;597;587;1869;1886;1876;1865;1171;1173;1167;1152;698;713;709;713;346;354;371;379;
2817052;"Rozogi (2)";5760;5714;5709;5655;1327;1238;1205;1155;3686;3716;3736;3724;2429;2434;2420;2386;1257;1282;1316;1338;747;760;768;776;
2817062;"Szczytno (2)";12076;12247;12473;12592;2794;2767;2779;2755;7962;8090;8201;8241;5164;5230;5321;5363;2798;2860;2880;2878;1320;1390;1493;1596;
2817072;"Świętajno (2)";6101;6088;6076;6041;1240;1204;1196;1149;3951;3947;3915;3912;2465;2462;2445;2457;1486;1485;1470;1455;910;937;965;980;
2817082;"Wielbark (2)";6584;6588;6579;6528;1487;1436;1414;1358;4228;4272;4278;4254;2764;2788;2778;2752;1464;1484;1500;1502;869;880;887;916;
2818012;"Banie Mazurskie (2)";3928;3926;3921;3873;684;673;661;636;2505;2509;2495;2465;1498;1502;1498;1457;1007;1007;997;1008;739;744;765;772;
2818022;"Dubeninki (2)";3113;3096;3062;3031;617;598;569;580;1930;1927;1897;1854;1203;1199;1186;1162;727;728;711;692;566;571;596;597;
2818033;"Gołdap (3)";20473;20438;20370;20376;4339;4273;4184;4147;13310;13229;13150;13061;8566;8546;8482;8473;4744;4683;4668;4588;2824;2936;3036;3168;
2818034;"Gołdap - miasto (4)";13791;13808;13748;13726;2734;2728;2654;2632;9022;8951;8873;8779;5653;5623;5581;5558;3369;3328;3292;3221;2035;2129;2221;2315;
2818035;"Gołdap - obszar wiejski (5)";6682;6630;6622;6650;1605;1545;1530;1515;4288;4278;4277;4282;2913;2923;2901;2915;1375;1355;1376;1367;789;807;815;853;
2819012;"Budry (2)";2961;2955;2951;2957;593;570;550;560;1879;1869;1869;1854;1140;1135;1129;1136;739;734;740;718;489;516;532;543;
2819022;"Pozezdrze (2)";3375;3347;3328;3345;596;576;581;581;2200;2174;2134;2144;1331;1327;1301;1308;869;847;833;836;579;597;613;620;
2819033;"Węgorzewo (3)";17429;17391;17325;17149;3002;2964;2954;2861;11365;11236;11043;10857;6800;6755;6646;6550;4565;4481;4397;4307;3062;3191;3328;3431;
2819034;"Węgorzewo - miasto (4)";11774;11699;11661;11568;1960;1929;1921;1869;7699;7552;7425;7309;4558;4492;4411;4366;3141;3060;3014;2943;2115;2218;2315;2390;
2819035;"Węgorzewo - obszar wiejski (5)";5655;5692;5664;5581;1042;1035;1033;992;3666;3684;3618;3548;2242;2263;2235;2184;1424;1421;1383;1364;947;973;1013;1041;
2861011;"Elbląg (1)";123659;122899;122368;121642;21240;20803;20494;20038;80430;79142;77876;76605;48605;48197;47787;47332;31825;30945;30089;29273;21989;22954;23998;24999;
2862011;"Olsztyn (1)";174641;174675;173831;173444;28704;28725;28770;29013;114934;113616;111295;109143;72976;72554;71297;70105;41958;41062;39998;39038;31003;32334;33766;35288;
3001011;"Chodzież (1)";19651;19399;19299;19199;3432;3331;3286;3269;12497;12231;12007;11744;7641;7523;7440;7345;4856;4708;4567;4399;3722;3837;4006;4186;
3001022;"Budzyń (2)";8414;8452;8453;8426;1809;1788;1783;1736;5533;5519;5468;5423;3583;3596;3575;3576;1950;1923;1893;1847;1072;1145;1202;1267;
3001032;"Chodzież (2)";5803;5844;5943;5954;1238;1232;1299;1274;3822;3821;3814;3809;2392;2414;2423;2446;1430;1407;1391;1363;743;791;830;871;
3001043;"Margonin (3)";6386;6386;6374;6402;1410;1434;1410;1405;4103;4036;4006;3984;2594;2564;2558;2553;1509;1472;1448;1431;873;916;958;1013;
3001044;"Margonin - miasto (4)";3028;3034;3027;3025;603;615;592;585;1968;1938;1930;1905;1212;1199;1200;1194;756;739;730;711;457;481;505;535;
3001045;"Margonin - obszar wiejski (5)";3358;3352;3347;3377;807;819;818;820;2135;2098;2076;2079;1382;1365;1358;1359;753;733;718;720;416;435;453;478;
3001053;"Szamocin (3)";7562;7558;7553;7553;1720;1675;1658;1639;4738;4746;4709;4694;3114;3126;3103;3086;1624;1620;1606;1608;1104;1137;1186;1220;
3001054;"Szamocin - miasto (4)";4330;4343;4337;4324;931;928;927;907;2718;2716;2686;2665;1800;1814;1795;1783;918;902;891;882;681;699;724;752;
3001055;"Szamocin - obszar wiejski (5)";3232;3215;3216;3229;789;747;731;732;2020;2030;2023;2029;1314;1312;1308;1303;706;718;715;726;423;438;462;468;
3002011;"Czarnków (1)";11305;11256;11139;11029;2030;2026;1991;1935;7306;7159;6979;6823;4420;4343;4226;4155;2886;2816;2753;2668;1969;2071;2169;2271;
3002022;"Czarnków (2)";11231;11270;11359;11377;2447;2493;2512;2468;7288;7245;7244;7267;4645;4595;4610;4626;2643;2650;2634;2641;1496;1532;1603;1642;
3002032;"Drawsko (2)";5990;5974;5969;5939;1281;1237;1210;1168;3793;3777;3768;3757;2403;2395;2407;2388;1390;1382;1361;1369;916;960;991;1014;
3002043;"Krzyż Wielkopolski (3)";8769;8790;8759;8775;1715;1678;1642;1645;5607;5607;5561;5505;3496;3531;3489;3467;2111;2076;2072;2038;1447;1505;1556;1625;
3002044;"Krzyż Wielkopolski - miasto (4)";6180;6209;6171;6195;1198;1166;1130;1145;3887;3906;3867;3829;2409;2454;2410;2395;1478;1452;1457;1434;1095;1137;1174;1221;
3002045;"Krzyż Wielkopolski - obszar wiejski (5)";2589;2581;2588;2580;517;512;512;500;1720;1701;1694;1676;1087;1077;1079;1072;633;624;615;604;352;368;382;404;
3002052;"Lubasz (2)";7412;7457;7524;7572;1713;1736;1701;1701;4670;4658;4727;4746;3079;3077;3132;3146;1591;1581;1595;1600;1029;1063;1096;1125;
3002062;"Połajewo (2)";6210;6222;6206;6188;1386;1359;1332;1336;3902;3915;3891;3868;2576;2587;2540;2475;1326;1328;1351;1393;922;948;983;984;
3002073;"Trzcianka (3)";24509;24426;24465;24389;4993;4885;4862;4779;15698;15556;15409;15254;9775;9757;9708;9662;5923;5799;5701;5592;3818;3985;4194;4356;
3002074;"Trzcianka - miasto (4)";17382;17301;17323;17268;3380;3310;3314;3274;11138;10992;10846;10686;6879;6839;6769;6726;4259;4153;4077;3960;2864;2999;3163;3308;
3002075;"Trzcianka - obszar wiejski (5)";7127;7125;7142;7121;1613;1575;1548;1505;4560;4564;4563;4568;2896;2918;2939;2936;1664;1646;1624;1632;954;986;1031;1048;
3002083;"Wieleń (3)";12743;12686;12624;12621;2550;2469;2447;2423;8054;8022;7902;7854;5065;5027;4929;4922;2989;2995;2973;2932;2139;2195;2275;2344;
3002084;"Wieleń - miasto (4)";6029;6021;5995;6004;1092;1072;1079;1066;3813;3782;3693;3673;2341;2315;2260;2270;1472;1467;1433;1403;1124;1167;1223;1265;
3002085;"Wieleń - obszar wiejski (5)";6714;6665;6629;6617;1458;1397;1368;1357;4241;4240;4209;4181;2724;2712;2669;2652;1517;1528;1540;1529;1015;1028;1052;1079;
3003011;"Gniezno (1)";70141;69883;69686;69312;12729;12580;12553;12385;44689;44062;43397;42686;27877;27598;27268;26923;16812;16464;16129;15763;12723;13241;13736;14241;
3003023;"Czerniejewo (3)";7323;7302;7315;7298;1526;1496;1521;1512;4818;4795;4729;4667;3032;3024;2989;2996;1786;1771;1740;1671;979;1011;1065;1119;
3003024;"Czerniejewo - miasto (4)";2662;2642;2637;2616;549;523;524;517;1766;1746;1707;1671;1082;1075;1064;1063;684;671;643;608;347;373;406;428;
3003025;"Czerniejewo - obszar wiejski (5)";4661;4660;4678;4682;977;973;997;995;3052;3049;3022;2996;1950;1949;1925;1933;1102;1100;1097;1063;632;638;659;691;
3003032;"Gniezno (2)";10248;10597;10846;11130;2408;2503;2553;2648;6661;6851;7008;7100;4459;4575;4678;4753;2202;2276;2330;2347;1179;1243;1285;1382;
3003042;"Kiszkowo (2)";5408;5390;5436;5414;1170;1137;1138;1112;3473;3462;3457;3439;2221;2231;2256;2255;1252;1231;1201;1184;765;791;841;863;
3003053;"Kłecko (3)";7587;7593;7613;7603;1634;1621;1623;1605;4943;4927;4902;4865;3159;3166;3162;3153;1784;1761;1740;1712;1010;1045;1088;1133;
3003054;"Kłecko - miasto (4)";2670;2669;2681;2658;550;541;548;538;1745;1737;1726;1701;1077;1084;1079;1069;668;653;647;632;375;391;407;419;
3003055;"Kłecko - obszar wiejski (5)";4917;4924;4932;4945;1084;1080;1075;1067;3198;3190;3176;3164;2082;2082;2083;2084;1116;1108;1093;1080;635;654;681;714;
3003062;"Łubowo (2)";6094;6214;6280;6390;1463;1474;1471;1479;3852;3925;3949;4009;2531;2598;2616;2639;1321;1327;1333;1370;779;815;860;902;
3003072;"Mieleszyn (2)";4075;4053;4050;4031;949;948;924;900;2630;2586;2589;2564;1742;1706;1705;1700;888;880;884;864;496;519;537;567;
3003082;"Niechanowo (2)";5677;5718;5736;5770;1366;1369;1349;1333;3589;3603;3593;3609;2323;2333;2333;2360;1266;1270;1260;1249;722;746;794;828;
3003093;"Trzemeszno (3)";14443;14441;14406;14387;2958;2927;2883;2876;9295;9210;9106;8991;6010;5979;5923;5882;3285;3231;3183;3109;2190;2304;2417;2520;
3003094;"Trzemeszno - miasto (4)";7845;7843;7848;7792;1556;1522;1515;1503;5062;5021;4960;4877;3254;3236;3193;3160;1808;1785;1767;1717;1227;1300;1373;1412;
3003095;"Trzemeszno - obszar wiejski (5)";6598;6598;6558;6595;1402;1405;1368;1373;4233;4189;4146;4114;2756;2743;2730;2722;1477;1446;1416;1392;963;1004;1044;1108;
3003103;"Witkowo (3)";13664;13764;13707;13750;2750;2757;2739;2726;8922;8916;8794;8750;5610;5632;5560;5566;3312;3284;3234;3184;1992;2091;2174;2274;
3003104;"Witkowo - miasto (4)";7954;8014;7974;7998;1449;1454;1448;1427;5282;5273;5183;5147;3229;3257;3206;3202;2053;2016;1977;1945;1223;1287;1343;1424;
3003105;"Witkowo - obszar wiejski (5)";5710;5750;5733;5752;1301;1303;1291;1299;3640;3643;3611;3603;2381;2375;2354;2364;1259;1268;1257;1239;769;804;831;850;
3004013;"Borek Wielkopolski (3)";7654;7675;7601;7591;1608;1599;1566;1533;4860;4850;4781;4780;3029;3045;3004;3018;1831;1805;1777;1762;1186;1226;1254;1278;
3004014;"Borek Wielkopolski - miasto (4)";2534;2533;2538;2535;516;507;512;493;1667;1656;1637;1637;1042;1042;1043;1034;625;614;594;603;351;370;389;405;
3004015;"Borek Wielkopolski - obszar wiejski (5)";5120;5142;5063;5056;1092;1092;1054;1040;3193;3194;3144;3143;1987;2003;1961;1984;1206;1191;1183;1159;835;856;865;873;
3004023;"Gostyń (3)";27870;27884;27962;27975;5268;5204;5188;5161;18098;18002;17936;17763;11323;11275;11253;11223;6775;6727;6683;6540;4504;4678;4838;5051;
3004024;"Gostyń - miasto (4)";20183;20183;20237;20168;3600;3547;3534;3486;13160;13077;13024;12829;8063;8027;8013;7957;5097;5050;5011;4872;3423;3559;3679;3853;
3004025;"Gostyń - obszar wiejski (5)";7687;7701;7725;7807;1668;1657;1654;1675;4938;4925;4912;4934;3260;3248;3240;3266;1678;1677;1672;1668;1081;1119;1159;1198;
3004033;"Krobia (3)";13039;13003;13032;13086;2653;2574;2582;2589;8373;8374;8354;8349;5443;5433;5396;5371;2930;2941;2958;2978;2013;2055;2096;2148;
3004034;"Krobia - miasto (4)";4213;4187;4236;4270;856;818;841;844;2719;2700;2715;2719;1738;1716;1721;1719;981;984;994;1000;638;669;680;707;
3004035;"Krobia - obszar wiejski (5)";8826;8816;8796;8816;1797;1756;1741;1745;5654;5674;5639;5630;3705;3717;3675;3652;1949;1957;1964;1978;1375;1386;1416;1441;
3004042;"Pępowo (2)";6019;6012;5978;6006;1273;1254;1229;1237;3771;3764;3719;3716;2416;2429;2395;2397;1355;1335;1324;1319;975;994;1030;1053;
3004052;"Piaski (2)";8576;8611;8618;8621;1819;1824;1799;1792;5441;5447;5436;5427;3522;3526;3515;3478;1919;1921;1921;1949;1316;1340;1383;1402;
3004063;"Pogorzela (3)";5162;5117;5112;5102;1134;1078;1089;1051;3284;3271;3251;3261;2148;2144;2102;2117;1136;1127;1149;1144;744;768;772;790;
3004064;"Pogorzela - miasto (4)";2050;2046;2063;2080;448;441;450;431;1322;1312;1323;1349;852;847;842;858;470;465;481;491;280;293;290;300;
3004065;"Pogorzela - obszar wiejski (5)";3112;3071;3049;3022;686;637;639;620;1962;1959;1928;1912;1296;1297;1260;1259;666;662;668;653;464;475;482;490;
3004073;"Poniec (3)";7936;7937;7890;7849;1548;1558;1540;1528;5112;5077;5023;4963;3247;3253;3201;3155;1865;1824;1822;1808;1276;1302;1327;1358;
3004074;"Poniec - miasto (4)";2900;2910;2873;2846;501;507;503;500;1892;1882;1850;1803;1161;1173;1134;1104;731;709;716;699;507;521;520;543;
3004075;"Poniec - obszar wiejski (5)";5036;5027;5017;5003;1047;1051;1037;1028;3220;3195;3173;3160;2086;2080;2067;2051;1134;1115;1106;1109;769;781;807;815;
3005012;"Granowo (2)";5029;4991;5026;5057;1131;1086;1086;1097;3206;3201;3209;3207;2086;2076;2089;2094;1120;1125;1120;1113;692;704;731;753;
3005023;"Grodzisk Wielkopolski (3)";19401;19483;19582;19636;4046;4019;3988;3974;12587;12605;12599;12579;8093;8135;8145;8107;4494;4470;4454;4472;2768;2859;2995;3083;
3005024;"Grodzisk Wielkopolski - miasto (4)";14265;14339;14392;14404;2849;2847;2830;2792;9293;9290;9265;9233;5912;5943;5936;5905;3381;3347;3329;3328;2123;2202;2297;2379;
3005025;"Grodzisk Wielkopolski - obszar wiejski (5)";5136;5144;5190;5232;1197;1172;1158;1182;3294;3315;3334;3346;2181;2192;2209;2202;1113;1123;1125;1144;645;657;698;704;
3005032;"Kamieniec (2)";6550;6614;6628;6684;1407;1431;1402;1429;4224;4217;4229;4234;2690;2681;2707;2713;1534;1536;1522;1521;919;966;997;1021;
3005043;"Rakoniewice (3)";13012;13041;13115;13191;3053;3036;3017;3002;8334;8298;8328;8343;5466;5453;5494;5497;2868;2845;2834;2846;1625;1707;1770;1846;
3005044;"Rakoniewice - miasto (4)";3534;3523;3529;3587;800;789;793;778;2324;2307;2295;2329;1528;1516;1509;1540;796;791;786;789;410;427;441;480;
3005045;"Rakoniewice - obszar wiejski (5)";9478;9518;9586;9604;2253;2247;2224;2224;6010;5991;6033;6014;3938;3937;3985;3957;2072;2054;2048;2057;1215;1280;1329;1366;
3005053;"Wielichowo (3)";6871;6842;6866;6858;1545;1487;1455;1441;4410;4419;4446;4396;2871;2891;2907;2890;1539;1528;1539;1506;916;936;965;1021;
3005054;"Wielichowo - miasto (4)";1783;1766;1757;1751;394;373;351;332;1155;1158;1161;1158;750;745;744;742;405;413;417;416;234;235;245;261;
3005055;"Wielichowo - obszar wiejski (5)";5088;5076;5109;5107;1151;1114;1104;1109;3255;3261;3285;3238;2121;2146;2163;2148;1134;1115;1122;1090;682;701;720;760;
3006012;"Jaraczewo (2)";8401;8382;8360;8346;1826;1808;1777;1770;5308;5269;5225;5161;3381;3364;3330;3307;1927;1905;1895;1854;1267;1305;1358;1415;
3006023;"Jarocin (3)";45463;45470;45590;45653;8662;8589;8567;8580;29150;28953;28839;28589;18173;18118;18079;17921;10977;10835;10760;10668;7651;7928;8184;8484;
3006024;"Jarocin - miasto (4)";26278;26311;26394;26366;4607;4620;4661;4662;16997;16832;16697;16445;10318;10262;10235;10145;6679;6570;6462;6300;4674;4859;5036;5259;
3006025;"Jarocin - obszar wiejski (5)";19185;19159;19196;19287;4055;3969;3906;3918;12153;12121;12142;12144;7855;7856;7844;7776;4298;4265;4298;4368;2977;3069;3148;3225;
3006032;"Kotlin (2)";7291;7329;7345;7354;1551;1553;1559;1546;4661;4673;4654;4626;3018;3019;3014;2997;1643;1654;1640;1629;1079;1103;1132;1182;
3006043;"Żerków (3)";10488;10451;10480;10437;2281;2217;2200;2113;6633;6628;6589;6586;4225;4202;4177;4189;2408;2426;2412;2397;1574;1606;1691;1738;
3006044;"Żerków - miasto (4)";2164;2145;2149;2138;462;452;455;432;1397;1381;1368;1361;879;871;870;871;518;510;498;490;305;312;326;345;
3006045;"Żerków - obszar wiejski (5)";8324;8306;8331;8299;1819;1765;1745;1681;5236;5247;5221;5225;3346;3331;3307;3318;1890;1916;1914;1907;1269;1294;1365;1393;
3007012;"Blizanów (2)";9650;9734;9813;9818;1937;1945;1943;1911;6207;6247;6284;6270;4011;4046;4084;4076;2196;2201;2200;2194;1506;1542;1586;1637;
3007022;"Brzeziny (2)";5824;5822;5846;5854;1241;1224;1211;1206;3593;3590;3602;3592;2352;2337;2326;2313;1241;1253;1276;1279;990;1008;1033;1056;
3007032;"Ceków-Kolonia (2)";4774;4792;4835;4817;953;943;952;945;3034;3044;3038;3017;1910;1914;1920;1897;1124;1130;1118;1120;787;805;845;855;
3007042;"Godziesze Wielkie (2)";9061;9150;9249;9269;1883;1894;1893;1887;5745;5805;5874;5870;3770;3789;3810;3787;1975;2016;2064;2083;1433;1451;1482;1512;
3007052;"Koźminek (2)";7552;7550;7544;7553;1540;1507;1489;1465;4795;4821;4821;4811;3066;3088;3086;3081;1729;1733;1735;1730;1217;1222;1234;1277;
3007062;"Lisków (2)";5378;5330;5318;5282;1083;1040;1028;981;3286;3262;3259;3246;2134;2116;2094;2093;1152;1146;1165;1153;1009;1028;1031;1055;
3007072;"Mycielin (2)";4920;4929;4942;4933;970;945;936;930;3121;3126;3116;3090;1969;1985;1952;1952;1152;1141;1164;1138;829;858;890;913;
3007082;"Opatówek (2)";10769;10762;10758;10850;2103;2064;2047;2053;6772;6754;6709;6732;4282;4259;4249;4267;2490;2495;2460;2465;1894;1944;2002;2065;
3007093;"Stawiszyn (3)";7234;7215;7219;7204;1391;1374;1363;1353;4635;4623;4580;4536;2911;2906;2861;2821;1724;1717;1719;1715;1208;1218;1276;1315;
3007094;"Stawiszyn - miasto (4)";1585;1561;1542;1511;289;290;277;257;997;977;949;922;618;596;582;560;379;381;367;362;299;294;316;332;
3007095;"Stawiszyn - obszar wiejski (5)";5649;5654;5677;5693;1102;1084;1086;1096;3638;3646;3631;3614;2293;2310;2279;2261;1345;1336;1352;1353;909;924;960;983;
3007102;"Szczytniki (2)";7966;7953;7903;7888;1636;1600;1582;1565;5008;4996;4935;4922;3205;3187;3133;3108;1803;1809;1802;1814;1322;1357;1386;1401;
3007112;"Żelazków (2)";9312;9348;9387;9370;1829;1863;1851;1822;5979;5972;5987;5957;3786;3762;3752;3753;2193;2210;2235;2204;1504;1513;1549;1591;
3008012;"Baranów (2)";7764;7798;7793;7815;1645;1640;1595;1613;5040;5025;5033;5016;3270;3266;3280;3258;1770;1759;1753;1758;1079;1133;1165;1186;
3008022;"Bralin (2)";5933;5982;6010;6036;1285;1282;1285;1261;3781;3807;3787;3794;2447;2454;2423;2439;1334;1353;1364;1355;867;893;938;981;
3008033;"Kępno (3)";24806;24697;24754;24657;4759;4666;4661;4620;15917;15705;15592;15394;10079;9994;9961;9841;5838;5711;5631;5553;4130;4326;4501;4643;
3008034;"Kępno - miasto (4)";14657;14577;14559;14469;2574;2527;2505;2488;9481;9304;9164;8999;5835;5767;5726;5638;3646;3537;3438;3361;2602;2746;2890;2982;
3008035;"Kępno - obszar wiejski (5)";10149;10120;10195;10188;2185;2139;2156;2132;6436;6401;6428;6395;4244;4227;4235;4203;2192;2174;2193;2192;1528;1580;1611;1661;
3008042;"Łęka Opatowska (2)";5316;5305;5331;5314;1184;1158;1166;1140;3369;3356;3361;3364;2212;2203;2201;2199;1157;1153;1160;1165;763;791;804;810;
3008052;"Perzów (2)";3823;3811;3816;3807;749;738;736;733;2465;2460;2471;2449;1596;1596;1580;1571;869;864;891;878;609;613;609;625;
3008062;"Rychtal (2)";3934;3903;3889;3893;778;747;724;739;2577;2566;2554;2516;1638;1609;1618;1602;939;957;936;914;579;590;611;638;
3008072;"Trzcinica (2)";4879;4896;4898;4905;1027;1014;1003;985;3094;3093;3078;3066;2009;2024;1997;1995;1085;1069;1081;1071;758;789;817;854;
3009011;"Koło (1)";23064;23026;22834;22674;4039;4022;3977;3905;14845;14622;14258;13964;8990;8902;8710;8578;5855;5720;5548;5386;4180;4382;4599;4805;
3009022;"Babiak (2)";8085;8032;8062;8013;1653;1580;1552;1493;5091;5107;5152;5134;3288;3279;3298;3293;1803;1828;1854;1841;1341;1345;1358;1386;
3009032;"Chodów (2)";3317;3286;3241;3213;574;550;529;513;2056;2049;2033;2022;1209;1213;1220;1211;847;836;813;811;687;687;679;678;
3009043;"Dąbie (3)";6551;6534;6498;6486;1178;1122;1104;1083;4126;4130;4086;4060;2566;2574;2544;2550;1560;1556;1542;1510;1247;1282;1308;1343;
3009044;"Dąbie - miasto (4)";2099;2089;2061;2043;372;339;329;313;1345;1348;1323;1307;859;863;833;838;486;485;490;469;382;402;409;423;
3009045;"Dąbie - obszar wiejski (5)";4452;4445;4437;4443;806;783;775;770;2781;2782;2763;2753;1707;1711;1711;1712;1074;1071;1052;1041;865;880;899;920;
3009052;"Grzegorzew (2)";5725;5733;5743;5702;1218;1185;1163;1108;3534;3554;3578;3566;2292;2302;2312;2299;1242;1252;1266;1267;973;994;1002;1028;
3009063;"Kłodawa (3)";13360;13282;13172;13100;2518;2472;2395;2341;8374;8274;8192;8130;5130;5077;5043;5018;3244;3197;3149;3112;2468;2536;2585;2629;
3009064;"Kłodawa - miasto (4)";6776;6721;6635;6589;1200;1163;1118;1100;4336;4282;4210;4148;2625;2578;2536;2496;1711;1704;1674;1652;1240;1276;1307;1341;
3009065;"Kłodawa - obszar wiejski (5)";6584;6561;6537;6511;1318;1309;1277;1241;4038;3992;3982;3982;2505;2499;2507;2522;1533;1493;1475;1460;1228;1260;1278;1288;
3009072;"Koło (2)";7525;7560;7630;7628;1627;1625;1640;1615;4694;4711;4739;4754;3056;3065;3071;3069;1638;1646;1668;1685;1204;1224;1251;1259;
3009082;"Kościelec (2)";6680;6698;6723;6734;1431;1418;1411;1414;4148;4152;4171;4162;2645;2646;2652;2633;1503;1506;1519;1529;1101;1128;1141;1158;
3009092;"Olszówka (2)";4713;4652;4647;4582;933;874;853;828;2909;2889;2883;2836;1840;1838;1847;1807;1069;1051;1036;1029;871;889;911;918;
3009102;"Osiek Mały (2)";5998;5960;6006;6005;1375;1353;1326;1293;3756;3724;3783;3772;2459;2436;2474;2478;1297;1288;1309;1294;867;883;897;940;
3009113;"Przedecz (3)";4325;4314;4292;4262;841;827;808;796;2712;2710;2686;2664;1636;1625;1620;1602;1076;1085;1066;1062;772;777;798;802;
3009114;"Przedecz - miasto (4)";1782;1759;1753;1750;326;316;310;306;1130;1123;1113;1105;661;647;645;640;469;476;468;465;326;320;330;339;
3009115;"Przedecz - obszar wiejski (5)";2543;2555;2539;2512;515;511;498;490;1582;1587;1573;1559;975;978;975;962;607;609;598;597;446;457;468;463;
3010013;"Golina (3)";11819;11843;11864;11880;2331;2275;2222;2214;7846;7854;7845;7841;4955;4949;4956;4947;2891;2905;2889;2894;1642;1714;1797;1825;
3010014;"Golina - miasto (4)";4471;4478;4498;4493;864;839;824;816;3014;3014;3003;2997;1846;1856;1867;1859;1168;1158;1136;1138;593;625;671;680;
3010015;"Golina - obszar wiejski (5)";7348;7365;7366;7387;1467;1436;1398;1398;4832;4840;4842;4844;3109;3093;3089;3088;1723;1747;1753;1756;1049;1089;1126;1145;
3010022;"Grodziec (2)";5258;5264;5249;5246;1146;1119;1097;1090;3287;3324;3313;3304;2110;2117;2099;2078;1177;1207;1214;1226;825;821;839;852;
3010032;"Kazimierz Biskupi (2)";11186;11285;11339;11405;2258;2235;2208;2173;7443;7492;7508;7557;4775;4785;4754;4781;2668;2707;2754;2776;1485;1558;1623;1675;
3010043;"Kleczew (3)";9978;9996;10009;10032;2048;1988;1931;1896;6449;6493;6497;6503;4169;4168;4167;4151;2280;2325;2330;2352;1481;1515;1581;1633;
3010044;"Kleczew - miasto (4)";4243;4240;4230;4225;819;774;745;733;2833;2854;2848;2833;1790;1787;1768;1742;1043;1067;1080;1091;591;612;637;659;
3010045;"Kleczew - obszar wiejski (5)";5735;5756;5779;5807;1229;1214;1186;1163;3616;3639;3649;3670;2379;2381;2399;2409;1237;1258;1250;1261;890;903;944;974;
3010052;"Kramsk (2)";10739;10800;10927;11032;2318;2285;2259;2239;6796;6862;6977;7058;4497;4520;4567;4607;2299;2342;2410;2451;1625;1653;1691;1735;
3010062;"Krzymów (2)";7641;7752;7784;7857;1716;1736;1702;1709;4864;4920;4944;4979;3242;3270;3258;3267;1622;1650;1686;1712;1061;1096;1138;1169;
3010073;"Rychwał (3)";8406;8397;8435;8388;1764;1748;1719;1672;5352;5314;5334;5287;3488;3467;3495;3478;1864;1847;1839;1809;1290;1335;1382;1429;
3010074;"Rychwał - miasto (4)";2375;2369;2385;2375;480;478;476;467;1561;1533;1530;1502;975;955;971;960;586;578;559;542;334;358;379;406;
3010075;"Rychwał - obszar wiejski (5)";6031;6028;6050;6013;1284;1270;1243;1205;3791;3781;3804;3785;2513;2512;2524;2518;1278;1269;1280;1267;956;977;1003;1023;
3010082;"Rzgów (2)";7141;7156;7143;7171;1569;1539;1482;1457;4504;4541;4563;4603;2993;2983;2992;2993;1511;1558;1571;1610;1068;1076;1098;1111;
3010092;"Skulsk (2)";6240;6202;6180;6205;1335;1285;1247;1237;3873;3873;3877;3893;2522;2535;2535;2553;1351;1338;1342;1340;1032;1044;1056;1075;
3010103;"Sompolno (3)";10531;10554;10467;10418;2193;2152;2071;2013;6770;6801;6729;6670;4346;4393;4342;4331;2424;2408;2387;2339;1568;1601;1667;1735;
3010104;"Sompolno - miasto (4)";3685;3677;3612;3616;711;694;661;646;2441;2439;2400;2388;1529;1534;1488;1496;912;905;912;892;533;544;551;582;
3010105;"Sompolno - obszar wiejski (5)";6846;6877;6855;6802;1482;1458;1410;1367;4329;4362;4329;4282;2817;2859;2854;2835;1512;1503;1475;1447;1035;1057;1116;1153;
3010112;"Stare Miasto (2)";11463;11555;11716;11849;2572;2560;2553;2595;7443;7475;7565;7581;4856;4875;4935;4941;2587;2600;2630;2640;1448;1520;1598;1673;
3010123;"Ślesin (3)";13924;13990;14009;14028;2795;2747;2670;2621;8962;9007;9040;9039;5739;5787;5787;5771;3223;3220;3253;3268;2167;2236;2299;2368;
3010124;"Ślesin - miasto (4)";3152;3154;3151;3145;546;550;535;524;2106;2086;2082;2068;1279;1264;1269;1244;827;822;813;824;500;518;534;553;
3010125;"Ślesin - obszar wiejski (5)";10772;10836;10858;10883;2249;2197;2135;2097;6856;6921;6958;6971;4460;4523;4518;4527;2396;2398;2440;2444;1667;1718;1765;1815;
3010132;"Wierzbinek (2)";7579;7548;7567;7506;1701;1655;1630;1584;4732;4736;4752;4721;3084;3108;3124;3096;1648;1628;1628;1625;1146;1157;1185;1201;
3010142;"Wilczyn (2)";6332;6356;6295;6256;1399;1366;1317;1295;3991;4019;3991;3943;2606;2638;2615;2577;1385;1381;1376;1366;942;971;987;1018;
3011011;"Kościan (1)";24050;24011;23949;23745;4132;4059;4040;3987;15468;15349;15167;14860;9498;9461;9346;9125;5970;5888;5821;5735;4450;4603;4742;4898;
3011023;"Czempiń (3)";11428;11464;11473;11483;2246;2250;2222;2178;7448;7415;7368;7351;4653;4627;4620;4631;2795;2788;2748;2720;1734;1799;1883;1954;
3011024;"Czempiń - miasto (4)";5288;5280;5278;5309;1000;991;973;962;3492;3435;3398;3396;2125;2103;2103;2112;1367;1332;1295;1284;796;854;907;951;
3011025;"Czempiń - obszar wiejski (5)";6140;6184;6195;6174;1246;1259;1249;1216;3956;3980;3970;3955;2528;2524;2517;2519;1428;1456;1453;1436;938;945;976;1003;
3011032;"Kościan (2)";15696;15718;15810;15979;3261;3147;3144;3185;10278;10320;10331;10383;6534;6598;6572;6615;3744;3722;3759;3768;2157;2251;2335;2411;
3011043;"Krzywiń (3)";10032;10041;10027;10058;2137;2067;2032;2020;6397;6412;6395;6400;4052;4074;4085;4091;2345;2338;2310;2309;1498;1562;1600;1638;
3011044;"Krzywiń - miasto (4)";1629;1637;1635;1657;322;307;303;318;1075;1090;1095;1087;668;689;692;683;407;401;403;404;232;240;237;252;
3011045;"Krzywiń - obszar wiejski (5)";8403;8404;8392;8401;1815;1760;1729;1702;5322;5322;5300;5313;3384;3385;3393;3408;1938;1937;1907;1905;1266;1322;1363;1386;
3011053;"Śmigiel (3)";17637;17747;17764;17763;3654;3684;3686;3677;11309;11271;11192;11069;7200;7235;7210;7191;4109;4036;3982;3878;2674;2792;2886;3017;
3011054;"Śmigiel - miasto (4)";5572;5603;5631;5666;1112;1124;1139;1136;3548;3527;3510;3507;2229;2222;2227;2253;1319;1305;1283;1254;912;952;982;1023;
3011055;"Śmigiel - obszar wiejski (5)";12065;12144;12133;12097;2542;2560;2547;2541;7761;7744;7682;7562;4971;5013;4983;4938;2790;2731;2699;2624;1762;1840;1904;1994;
3012011;"Sulmierzyce (1)";2895;2905;2905;2907;665;661;646;662;1850;1846;1835;1816;1211;1231;1224;1204;639;615;611;612;380;398;424;429;
3012023;"Kobylin (3)";8240;8183;8177;8164;1800;1744;1713;1692;5161;5138;5112;5086;3263;3263;3250;3251;1898;1875;1862;1835;1279;1301;1352;1386;
3012024;"Kobylin - miasto (4)";3282;3236;3263;3294;728;684;687;696;2059;2050;2045;2053;1300;1297;1300;1308;759;753;745;745;495;502;531;545;
3012025;"Kobylin - obszar wiejski (5)";4958;4947;4914;4870;1072;1060;1026;996;3102;3088;3067;3033;1963;1966;1950;1943;1139;1122;1117;1090;784;799;821;841;
3012033;"Koźmin Wielkopolski (3)";13587;13533;13504;13397;2787;2756;2725;2649;8469;8388;8328;8246;5388;5317;5272;5211;3081;3071;3056;3035;2331;2389;2451;2502;
3012034;"Koźmin Wielkopolski - miasto (4)";6707;6698;6701;6608;1237;1232;1218;1156;4214;4171;4154;4094;2594;2558;2547;2504;1620;1613;1607;1590;1256;1295;1329;1358;
3012035;"Koźmin Wielkopolski - obszar wiejski (5)";6880;6835;6803;6789;1550;1524;1507;1493;4255;4217;4174;4152;2794;2759;2725;2707;1461;1458;1449;1445;1075;1094;1122;1144;
3012043;"Krotoszyn (3)";40869;40718;40684;40553;8061;7898;7868;7796;26132;25945;25680;25394;16358;16281;16201;16025;9774;9664;9479;9369;6676;6875;7136;7363;
3012044;"Krotoszyn - miasto (4)";29577;29397;29284;29129;5532;5406;5390;5313;19024;18810;18508;18243;11744;11642;11526;11350;7280;7168;6982;6893;5021;5181;5386;5573;
3012045;"Krotoszyn - obszar wiejski (5)";11292;11321;11400;11424;2529;2492;2478;2483;7108;7135;7172;7151;4614;4639;4675;4675;2494;2496;2497;2476;1655;1694;1750;1790;
3012052;"Rozdrażew (2)";5202;5192;5185;5191;1179;1167;1149;1132;3289;3274;3273;3281;2132;2111;2105;2112;1157;1163;1168;1169;734;751;763;778;
3012063;"Zduny (3)";7344;7427;7454;7452;1481;1512;1517;1512;4769;4808;4781;4757;2994;3035;3048;3056;1775;1773;1733;1701;1094;1107;1156;1183;
3012064;"Zduny - miasto (4)";4562;4587;4579;4561;911;924;929;912;2988;2991;2956;2939;1891;1902;1894;1901;1097;1089;1062;1038;663;672;694;710;
3012065;"Zduny - obszar wiejski (5)";2782;2840;2875;2891;570;588;588;600;1781;1817;1825;1818;1103;1133;1154;1155;678;684;671;663;431;435;462;473;
3013012;"Krzemieniewo (2)";8503;8527;8457;8404;1762;1755;1693;1694;5541;5494;5431;5313;3455;3443;3424;3333;2086;2051;2007;1980;1200;1278;1333;1397;
3013022;"Lipno (2)";7030;7189;7335;7544;1705;1712;1745;1806;4504;4601;4677;4756;3078;3147;3197;3285;1426;1454;1480;1471;821;876;913;982;
3013033;"Osieczna (3)";8933;8968;8994;9059;1824;1814;1777;1794;5668;5672;5700;5713;3650;3651;3681;3684;2018;2021;2019;2029;1441;1482;1517;1552;
3013034;"Osieczna - miasto (4)";2206;2245;2265;2288;413;430;419;436;1421;1429;1437;1436;868;891;909;900;553;538;528;536;372;386;409;416;
3013035;"Osieczna - obszar wiejski (5)";6727;6723;6729;6771;1411;1384;1358;1358;4247;4243;4263;4277;2782;2760;2772;2784;1465;1483;1491;1493;1069;1096;1108;1136;
3013043;"Rydzyna (3)";8623;8738;8837;8849;1899;1915;1930;1915;5535;5560;5601;5554;3617;3654;3659;3648;1918;1906;1942;1906;1189;1263;1306;1380;
3013044;"Rydzyna - miasto (4)";2711;2762;2790;2738;574;593;607;576;1753;1754;1743;1698;1144;1151;1142;1098;609;603;601;600;384;415;440;464;
3013045;"Rydzyna - obszar wiejski (5)";5912;5976;6047;6111;1325;1322;1323;1339;3782;3806;3858;3856;2473;2503;2517;2550;1309;1303;1341;1306;805;848;866;916;
3013052;"Święciechowa (2)";7549;7661;7751;7789;1606;1620;1634;1628;4931;4963;4985;4992;3212;3249;3277;3240;1719;1714;1708;1752;1012;1078;1132;1169;
3013062;"Wijewo (2)";3740;3756;3802;3798;946;930;927;907;2325;2335;2366;2363;1587;1596;1612;1601;738;739;754;762;469;491;509;528;
3013072;"Włoszakowice (2)";9092;9200;9246;9324;2077;2076;2102;2094;5727;5793;5765;5809;3827;3849;3797;3839;1900;1944;1968;1970;1288;1331;1379;1421;
3014012;"Chrzypsko Wielkie (2)";3403;3390;3411;3358;734;729;720;688;2111;2092;2086;2035;1341;1328;1326;1306;770;764;760;729;558;569;605;635;
3014022;"Kwilcz (2)";6273;6282;6314;6323;1357;1334;1332;1334;4068;4061;4039;4009;2560;2559;2576;2574;1508;1502;1463;1435;848;887;943;980;
3014033;"Międzychód (3)";18663;18652;18609;18612;3654;3608;3523;3493;12034;11918;11788;11696;7544;7520;7452;7419;4490;4398;4336;4277;2975;3126;3298;3423;
3014034;"Międzychód - miasto (4)";10913;10805;10723;10681;2079;2030;1971;1925;6961;6811;6681;6590;4333;4257;4181;4164;2628;2554;2500;2426;1873;1964;2071;2166;
3014035;"Międzychód - obszar wiejski (5)";7750;7847;7886;7931;1575;1578;1552;1568;5073;5107;5107;5106;3211;3263;3271;3255;1862;1844;1836;1851;1102;1162;1227;1257;
3014043;"Sieraków (3)";8768;8770;8792;8791;1799;1773;1726;1720;5593;5577;5589;5543;3521;3541;3556;3524;2072;2036;2033;2019;1376;1420;1477;1528;
3014044;"Sieraków - miasto (4)";6118;6117;6089;6065;1220;1205;1161;1145;3891;3868;3855;3816;2460;2471;2457;2423;1431;1397;1398;1393;1007;1044;1073;1104;
3014045;"Sieraków - obszar wiejski (5)";2650;2653;2703;2726;579;568;565;575;1702;1709;1734;1727;1061;1070;1099;1101;641;639;635;626;369;376;404;424;
3015012;"Kuślin (2)";5615;5640;5561;5573;1306;1329;1275;1278;3527;3501;3466;3459;2299;2287;2245;2244;1228;1214;1221;1215;782;810;820;836;
3015023;"Lwówek (3)";9361;9356;9329;9345;2137;2090;2076;2034;5794;5800;5757;5776;3780;3799;3775;3776;2014;2001;1982;2000;1430;1466;1496;1535;
3015024;"Lwówek - miasto (4)";3052;3058;3042;3038;621;610;605;593;1892;1884;1861;1857;1188;1199;1183;1173;704;685;678;684;539;564;576;588;
3015025;"Lwówek - obszar wiejski (5)";6309;6298;6287;6307;1516;1480;1471;1441;3902;3916;3896;3919;2592;2600;2592;2603;1310;1316;1304;1316;891;902;920;947;
3015032;"Miedzichowo (2)";3691;3665;3638;3654;727;705;684;707;2412;2395;2349;2318;1540;1532;1529;1511;872;863;820;807;552;565;605;629;
3015043;"Nowy Tomyśl (3)";25615;25764;26051;26207;5339;5337;5384;5380;16530;16460;16490;16435;10563;10604;10694;10746;5967;5856;5796;5689;3746;3967;4177;4392;
3015044;"Nowy Tomyśl - miasto (4)";15024;14899;14974;14867;2741;2682;2721;2690;9796;9594;9479;9264;6046;5962;5953;5870;3750;3632;3526;3394;2487;2623;2774;2913;
3015045;"Nowy Tomyśl - obszar wiejski (5)";10591;10865;11077;11340;2598;2655;2663;2690;6734;6866;7011;7171;4517;4642;4741;4876;2217;2224;2270;2295;1259;1344;1403;1479;
3015053;"Opalenica (3)";16182;16299;16304;16303;3338;3332;3339;3353;10387;10413;10302;10201;6713;6748;6693;6608;3674;3665;3609;3593;2457;2554;2663;2749;
3015054;"Opalenica - miasto (4)";9534;9591;9621;9610;1847;1842;1861;1894;6176;6173;6092;6009;3950;3979;3941;3851;2226;2194;2151;2158;1511;1576;1668;1707;
3015055;"Opalenica - obszar wiejski (5)";6648;6708;6683;6693;1491;1490;1478;1459;4211;4240;4210;4192;2763;2769;2752;2757;1448;1471;1458;1435;946;978;995;1042;
3015063;"Zbąszyń (3)";13572;13612;13655;13643;2782;2756;2781;2772;8672;8658;8616;8578;5632;5667;5639;5621;3040;2991;2977;2957;2118;2198;2258;2293;
3015064;"Zbąszyń - miasto (4)";7192;7202;7235;7224;1301;1284;1323;1326;4687;4664;4624;4583;2952;2973;2965;2955;1735;1691;1659;1628;1204;1254;1288;1315;
3015065;"Zbąszyń - obszar wiejski (5)";6380;6410;6420;6419;1481;1472;1458;1446;3985;3994;3992;3995;2680;2694;2674;2666;1305;1300;1318;1329;914;944;970;978;
3016013;"Oborniki (3)";33348;33454;33646;33830;6807;6806;6861;6884;21744;21588;21458;21337;13923;13881;13893;13874;7821;7707;7565;7463;4797;5060;5327;5609;
3016014;"Oborniki - miasto (4)";18451;18421;18426;18395;3489;3491;3513;3516;12038;11852;11666;11484;7533;7461;7410;7308;4505;4391;4256;4176;2924;3078;3247;3395;
3016015;"Oborniki - obszar wiejski (5)";14897;15033;15220;15435;3318;3315;3348;3368;9706;9736;9792;9853;6390;6420;6483;6566;3316;3316;3309;3287;1873;1982;2080;2214;
3016023;"Rogoźno (3)";18256;18263;18208;18222;3950;3885;3788;3779;11726;11686;11592;11485;7472;7470;7460;7403;4254;4216;4132;4082;2580;2692;2828;2958;
3016024;"Rogoźno - miasto (4)";11345;11309;11229;11208;2331;2296;2221;2237;7308;7227;7137;7020;4625;4600;4566;4501;2683;2627;2571;2519;1706;1786;1871;1951;
3016025;"Rogoźno - obszar wiejski (5)";6911;6954;6979;7014;1619;1589;1567;1542;4418;4459;4455;4465;2847;2870;2894;2902;1571;1589;1561;1563;874;906;957;1007;
3016032;"Ryczywół (2)";7413;7384;7429;7449;1702;1664;1665;1652;4713;4687;4688;4675;3028;3025;3055;3076;1685;1662;1633;1599;998;1033;1076;1122;
3017011;"Ostrów Wielkopolski (1)";72933;72890;72754;72635;12202;12210;12155;12081;46731;46103;45469;44884;28515;28231;27898;27634;18216;17872;17571;17250;14000;14577;15130;15670;
3017023;"Nowe Skalmierzyce (3)";15163;15140;15246;15264;2999;2942;2963;2937;9844;9799;9810;9777;6242;6226;6250;6266;3602;3573;3560;3511;2320;2399;2473;2550;
3017024;"Nowe Skalmierzyce - miasto (4)";4855;4830;4871;4832;885;870;889;868;3180;3153;3143;3077;1926;1914;1948;1935;1254;1239;1195;1142;790;807;839;887;
3017025;"Nowe Skalmierzyce - obszar wiejski (5)";10308;10310;10375;10432;2114;2072;2074;2069;6664;6646;6667;6700;4316;4312;4302;4331;2348;2334;2365;2369;1530;1592;1634;1663;
3017033;"Odolanów (3)";14318;14393;14432;14446;3055;3001;2961;2919;9206;9269;9284;9254;6012;6060;6046;6042;3194;3209;3238;3212;2057;2123;2187;2273;
3017034;"Odolanów - miasto (4)";5089;5116;5134;5104;1009;1016;1012;996;3357;3332;3323;3274;2158;2156;2134;2119;1199;1176;1189;1155;723;768;799;834;
3017035;"Odolanów - obszar wiejski (5)";9229;9277;9298;9342;2046;1985;1949;1923;5849;5937;5961;5980;3854;3904;3912;3923;1995;2033;2049;2057;1334;1355;1388;1439;
3017042;"Ostrów Wielkopolski (2)";18732;18782;18909;18999;3904;3835;3813;3796;12016;12066;12118;12140;7772;7807;7794;7770;4244;4259;4324;4370;2812;2881;2978;3063;
3017052;"Przygodzice (2)";11901;11950;12014;11995;2505;2493;2475;2417;7606;7597;7627;7628;4928;4913;4895;4892;2678;2684;2732;2736;1790;1860;1912;1950;
3017063;"Raszków (3)";11812;11833;11835;11829;2624;2554;2511;2480;7460;7466;7440;7445;4823;4860;4823;4815;2637;2606;2617;2630;1728;1813;1884;1904;
3017064;"Raszków - miasto (4)";2073;2076;2080;2089;414;395;399;399;1436;1438;1421;1415;896;905;887;879;540;533;534;536;223;243;260;275;
3017065;"Raszków - obszar wiejski (5)";9739;9757;9755;9740;2210;2159;2112;2081;6024;6028;6019;6030;3927;3955;3936;3936;2097;2073;2083;2094;1505;1570;1624;1629;
3017072;"Sieroszewice (2)";9646;9650;9631;9659;1944;1924;1869;1873;6225;6226;6233;6243;3942;3944;3928;3940;2283;2282;2305;2303;1477;1500;1529;1543;
3017082;"Sośnie (2)";6563;6578;6582;6608;1407;1373;1359;1339;4246;4257;4237;4260;2793;2820;2792;2817;1453;1437;1445;1443;910;948;986;1009;
3018012;"Czajków (2)";2505;2496;2499;2479;514;482;462;458;1546;1559;1577;1554;979;976;984;964;567;583;593;590;445;455;460;467;
3018022;"Doruchów (2)";5242;5270;5297;5306;1180;1152;1150;1135;3325;3356;3369;3358;2140;2162;2147;2149;1185;1194;1222;1209;737;762;778;813;
3018033;"Grabów nad Prosną (3)";7787;7844;7819;7813;1624;1607;1579;1546;4891;4933;4890;4899;3074;3095;3102;3108;1817;1838;1788;1791;1272;1304;1350;1368;
3018034;"Grabów nad Prosną - miasto (4)";1967;1976;1969;1958;387;382;378;377;1248;1250;1224;1202;775;778;770;761;473;472;454;441;332;344;367;379;
3018035;"Grabów nad Prosną - obszar wiejski (5)";5820;5868;5850;5855;1237;1225;1201;1169;3643;3683;3666;3697;2299;2317;2332;2347;1344;1366;1334;1350;940;960;983;989;
3018042;"Kobyla Góra (2)";6121;6172;6147;6160;1259;1244;1230;1219;3978;4003;3970;3963;2524;2522;2481;2481;1454;1481;1489;1482;884;925;947;978;
3018052;"Kraszewice (2)";3661;3664;3643;3625;813;801;772;752;2259;2277;2257;2260;1466;1482;1477;1487;793;795;780;773;589;586;614;613;
3018063;"Mikstat (3)";6175;6135;6112;6116;1225;1184;1177;1179;3995;3951;3906;3892;2512;2488;2458;2431;1483;1463;1448;1461;955;1000;1029;1045;
3018064;"Mikstat - miasto (4)";1911;1904;1884;1885;351;336;335;338;1298;1282;1256;1252;800;791;772;768;498;491;484;484;262;286;293;295;
3018065;"Mikstat - obszar wiejski (5)";4264;4231;4228;4231;874;848;842;841;2697;2669;2650;2640;1712;1697;1686;1663;985;972;964;977;693;714;736;750;
3018073;"Ostrzeszów (3)";23886;23873;23888;23910;4789;4727;4648;4587;15216;15089;14974;14878;9645;9607;9613;9579;5571;5482;5361;5299;3881;4057;4266;4445;
3018074;"Ostrzeszów - miasto (4)";14546;14515;14511;14432;2621;2608;2570;2514;9336;9165;9045;8898;5753;5691;5672;5612;3583;3474;3373;3286;2589;2742;2896;3020;
3018075;"Ostrzeszów - obszar wiejski (5)";9340;9358;9377;9478;2168;2119;2078;2073;5880;5924;5929;5980;3892;3916;3941;3967;1988;2008;1988;2013;1292;1315;1370;1425;
3019011;"Piła (1)";74930;74609;74333;74140;13617;13467;13251;13134;48575;47735;47007;46399;29954;29486;29189;28977;18621;18249;17818;17422;12738;13407;14075;14607;
3019022;"Białośliwie (2)";4966;4934;4957;4951;1140;1097;1092;1071;3145;3136;3155;3142;2015;2018;2030;2020;1130;1118;1125;1122;681;701;710;738;
3019032;"Kaczory (2)";7787;7847;7850;7909;1619;1616;1594;1599;5133;5163;5127;5142;3380;3378;3377;3380;1753;1785;1750;1762;1035;1068;1129;1168;
3019043;"Łobżenica (3)";9792;9775;9751;9706;2107;2048;2005;1953;6263;6255;6235;6190;3923;3922;3927;3902;2340;2333;2308;2288;1422;1472;1511;1563;
3019044;"Łobżenica - miasto (4)";3054;3038;2997;2986;557;526;496;472;2044;2028;2001;1974;1221;1218;1209;1203;823;810;792;771;453;484;500;540;
3019045;"Łobżenica - obszar wiejski (5)";6738;6737;6754;6720;1550;1522;1509;1481;4219;4227;4234;4216;2702;2704;2718;2699;1517;1523;1516;1517;969;988;1011;1023;
3019052;"Miasteczko Krajeńskie (2)";3231;3243;3247;3239;672;683;687;686;2049;2033;2019;1997;1311;1309;1308;1302;738;724;711;695;510;527;541;556;
3019062;"Szydłowo (2)";8500;8660;8704;8760;1862;1903;1854;1825;5697;5776;5834;5872;3670;3704;3722;3718;2027;2072;2112;2154;941;981;1016;1063;
3019073;"Ujście (3)";8118;8093;8079;8020;1602;1566;1524;1474;5268;5243;5244;5194;3327;3315;3284;3256;1941;1928;1960;1938;1248;1284;1311;1352;
3019074;"Ujście - miasto (4)";3868;3828;3802;3755;739;718;687;668;2460;2425;2410;2375;1521;1503;1483;1451;939;922;927;924;669;685;705;712;
3019075;"Ujście - obszar wiejski (5)";4250;4265;4277;4265;863;848;837;806;2808;2818;2834;2819;1806;1812;1801;1805;1002;1006;1033;1014;579;599;606;640;
3019083;"Wyrzysk (3)";14226;14214;14132;14096;3038;2961;2870;2799;9156;9154;9060;9021;5776;5791;5752;5743;3380;3363;3308;3278;2032;2099;2202;2276;
3019084;"Wyrzysk - miasto (4)";5226;5191;5179;5174;1015;968;944;910;3449;3431;3396;3383;2072;2051;2060;2063;1377;1380;1336;1320;762;792;839;881;
3019085;"Wyrzysk - obszar wiejski (5)";9000;9023;8953;8922;2023;1993;1926;1889;5707;5723;5664;5638;3704;3740;3692;3680;2003;1983;1972;1958;1270;1307;1363;1395;
3019093;"Wysoka (3)";6856;6843;6787;6749;1516;1489;1434;1414;4410;4393;4368;4306;2801;2802;2804;2770;1609;1591;1564;1536;930;961;985;1029;
3019094;"Wysoka - miasto (4)";2742;2758;2707;2712;586;585;557;570;1782;1786;1754;1718;1065;1078;1067;1059;717;708;687;659;374;387;396;424;
3019095;"Wysoka - obszar wiejski (5)";4114;4085;4080;4037;930;904;877;844;2628;2607;2614;2588;1736;1724;1737;1711;892;883;877;877;556;574;589;605;
3020012;"Chocz (2)";4754;4726;4741;;974;941;936;;3045;3049;3055;;1999;1995;1995;;1046;1054;1060;;735;736;750;;
3020013;"Chocz (3)";;;;4764;;;;928;;;;3058;;;;1995;;;;1063;;;;778;
3020014;"Chocz - miasto (4)";;;;1802;;;;348;;;;1157;;;;750;;;;407;;;;297;
3020015;"Chocz - obszar wiejski (5)";;;;2962;;;;580;;;;1901;;;;1245;;;;656;;;;481;
3020022;"Czermin (2)";4894;4897;4885;4893;1048;1031;1015;1025;3137;3124;3104;3084;2034;2024;2019;2010;1103;1100;1085;1074;709;742;766;784;
3020032;"Dobrzyca (2)";8407;8346;;;1800;1754;;;5278;5223;;;3403;3355;;;1875;1868;;;1329;1369;;;
3020033;"Dobrzyca (3)";;;8302;8253;;;1730;1712;;;5165;5126;;;3328;3293;;;1837;1833;;;1407;1415;
3020034;"Dobrzyca - miasto (4)";;;3167;3183;;;650;648;;;1950;1959;;;1253;1258;;;697;701;;;567;576;
3020035;"Dobrzyca - obszar wiejski (5)";;;5135;5070;;;1080;1064;;;3215;3167;;;2075;2035;;;1140;1132;;;840;839;
3020042;"Gizałki (2)";4672;4673;4673;4670;1095;1083;1061;1038;2934;2926;2919;2927;1949;1945;1946;1949;985;981;973;978;643;664;693;705;
3020052;"Gołuchów (2)";10338;10418;10422;10471;2197;2163;2133;2098;6601;6666;6645;6673;4334;4372;4344;4348;2267;2294;2301;2325;1540;1589;1644;1700;
3020063;"Pleszew (3)";30290;30236;30259;30201;5720;5632;5648;5618;19421;19249;19049;18787;12223;12154;12067;11861;7198;7095;6982;6926;5149;5355;5562;5796;
3020064;"Pleszew - miasto (4)";17862;17759;17717;17650;3031;2965;2956;2946;11400;11240;11094;10874;7041;6966;6870;6705;4359;4274;4224;4169;3431;3554;3667;3830;
3020065;"Pleszew - obszar wiejski (5)";12428;12477;12542;12551;2689;2667;2692;2672;8021;8009;7955;7913;5182;5188;5197;5156;2839;2821;2758;2757;1718;1801;1895;1966;
3021011;"Luboń (1)";30297;30676;30813;31067;6238;6317;6337;6427;19354;19448;19371;19354;13010;13107;12986;12902;6344;6341;6385;6452;4705;4911;5105;5286;
3021021;"Puszczykowo (1)";9787;9819;9802;9753;1749;1750;1747;1738;6217;6162;6063;5954;3688;3648;3594;3544;2529;2514;2469;2410;1821;1907;1992;2061;
3021033;"Buk (3)";12347;12348;12375;12389;2584;2570;2512;2497;7932;7883;7882;7838;5185;5155;5153;5132;2747;2728;2729;2706;1831;1895;1981;2054;
3021034;"Buk - miasto (4)";6220;6225;6188;6151;1210;1225;1170;1160;3928;3866;3847;3794;2576;2531;2513;2484;1352;1335;1334;1310;1082;1134;1171;1197;
3021035;"Buk - obszar wiejski (5)";6127;6123;6187;6238;1374;1345;1342;1337;4004;4017;4035;4044;2609;2624;2640;2648;1395;1393;1395;1396;749;761;810;857;
3021042;"Czerwonak (2)";26529;26750;26861;27094;5490;5487;5483;5491;17921;17894;17797;17736;11379;11386;11359;11354;6542;6508;6438;6382;3118;3369;3581;3867;
3021052;"Dopiewo (2)";20318;21489;22447;23453;5104;5503;5846;6193;13038;13652;14131;14599;9062;9570;9939;10319;3976;4082;4192;4280;2176;2334;2470;2661;
3021062;"Kleszczewo (2)";6623;6951;7221;7500;1674;1781;1852;1946;4230;4422;4588;4714;2981;3124;3255;3340;1249;1298;1333;1374;719;748;781;840;
3021072;"Komorniki (2)";22076;23210;24433;25572;5482;5814;6194;6563;14266;14904;15601;16194;10403;10915;11446;11884;3863;3989;4155;4310;2328;2492;2638;2815;
3021083;"Kostrzyn (3)";17317;17465;17593;17741;3680;3674;3679;3714;11281;11354;11348;11360;7336;7372;7394;7421;3945;3982;3954;3939;2356;2437;2566;2667;
3021084;"Kostrzyn - miasto (4)";9426;9492;9542;9598;1920;1917;1908;1909;6143;6165;6134;6141;3938;3944;3925;3944;2205;2221;2209;2197;1363;1410;1500;1548;
3021085;"Kostrzyn - obszar wiejski (5)";7891;7973;8051;8143;1760;1757;1771;1805;5138;5189;5214;5219;3398;3428;3469;3477;1740;1761;1745;1742;993;1027;1066;1119;
3021093;"Kórnik (3)";22232;23075;23817;24774;5183;5393;5587;5924;14251;14707;15111;15550;9593;9985;10276;10621;4658;4722;4835;4929;2798;2975;3119;3300;
3021094;"Kórnik - miasto (4)";7351;7530;7684;7764;1522;1583;1631;1667;4630;4683;4724;4727;3116;3168;3204;3207;1514;1515;1520;1520;1199;1264;1329;1370;
3021095;"Kórnik - obszar wiejski (5)";14881;15545;16133;17010;3661;3810;3956;4257;9621;10024;10387;10823;6477;6817;7072;7414;3144;3207;3315;3409;1599;1711;1790;1930;
3021103;"Mosina (3)";29121;29824;30500;31088;6079;6208;6382;6528;18827;19168;19416;19591;12193;12557;12787;12996;6634;6611;6629;6595;4215;4448;4702;4969;
3021104;"Mosina - miasto (4)";12941;13065;13220;13403;2467;2475;2516;2582;8279;8292;8261;8253;5156;5238;5249;5307;3123;3054;3012;2946;2195;2298;2443;2568;
3021105;"Mosina - obszar wiejski (5)";16180;16759;17280;17685;3612;3733;3866;3946;10548;10876;11155;11338;7037;7319;7538;7689;3511;3557;3617;3649;2020;2150;2259;2401;
3021113;"Murowana Goślina (3)";16658;16663;16732;16760;3300;3279;3251;3228;11475;11377;11360;11305;7035;6989;7009;6982;4440;4388;4351;4323;1883;2007;2121;2227;
3021114;"Murowana Goślina - miasto (4)";10437;10386;10424;10449;1928;1905;1891;1882;7392;7269;7243;7214;4399;4329;4335;4321;2993;2940;2908;2893;1117;1212;1290;1353;
3021115;"Murowana Goślina - obszar wiejski (5)";6221;6277;6308;6311;1372;1374;1360;1346;4083;4108;4117;4091;2636;2660;2674;2661;1447;1448;1443;1430;766;795;831;874;
3021123;"Pobiedziska (3)";18580;18814;18969;19106;3853;3883;3907;3961;12071;12130;12131;12139;7769;7849;7809;7765;4302;4281;4322;4374;2656;2801;2931;3006;
3021124;"Pobiedziska - miasto (4)";8997;9043;9091;9114;1811;1816;1834;1849;5829;5821;5803;5786;3789;3804;3757;3727;2040;2017;2046;2059;1357;1406;1454;1479;
3021125;"Pobiedziska - obszar wiejski (5)";9583;9771;9878;9992;2042;2067;2073;2112;6242;6309;6328;6353;3980;4045;4052;4038;2262;2264;2276;2315;1299;1395;1477;1527;
3021132;"Rokietnica (2)";13919;14565;15078;15679;3451;3618;3745;3939;8930;9305;9572;9849;6180;6446;6648;6812;2750;2859;2924;3037;1538;1642;1761;1891;
3021143;"Stęszew (3)";14756;14791;14899;14910;2994;2978;3000;2951;9673;9646;9628;9594;6136;6120;6121;6118;3537;3526;3507;3476;2089;2167;2271;2365;
3021144;"Stęszew - miasto (4)";5824;5834;5903;5933;1188;1175;1214;1211;3819;3803;3781;3761;2418;2417;2405;2402;1401;1386;1376;1359;817;856;908;961;
3021145;"Stęszew - obszar wiejski (5)";8932;8957;8996;8977;1806;1803;1786;1740;5854;5843;5847;5833;3718;3703;3716;3716;2136;2140;2131;2117;1272;1311;1363;1404;
3021152;"Suchy Las (2)";15614;15971;16209;16510;3699;3811;3851;3934;9921;10002;10020;10066;6515;6567;6613;6608;3406;3435;3407;3458;1994;2158;2338;2510;
3021163;"Swarzędz (3)";45807;46530;47160;47947;9582;9741;9850;10104;30028;30304;30415;30498;19781;20019;20177;20224;10247;10285;10238;10274;6197;6485;6895;7345;
3021164;"Swarzędz - miasto (4)";31100;31084;31035;31006;6077;6022;5931;5901;20521;20357;20110;19795;13352;13244;13103;12864;7169;7113;7007;6931;4502;4705;4994;5310;
3021165;"Swarzędz - obszar wiejski (5)";14707;15446;16125;16941;3505;3719;3919;4203;9507;9947;10305;10703;6429;6775;7074;7360;3078;3172;3231;3343;1695;1780;1901;2035;
3021172;"Tarnowo Podgórne (2)";22771;23454;23985;24694;5057;5249;5355;5574;14642;14922;15090;15353;9530;9794;9938;10105;5112;5128;5152;5248;3072;3283;3540;3767;
3022013;"Bojanowo (3)";8934;8917;8936;8831;1865;1834;1788;1738;5627;5587;5590;5495;3583;3580;3611;3555;2044;2007;1979;1940;1442;1496;1558;1598;
3022014;"Bojanowo - miasto (4)";2998;2970;2975;2952;577;549;529;537;1834;1827;1831;1794;1165;1159;1170;1156;669;668;661;638;587;594;615;621;
3022015;"Bojanowo - obszar wiejski (5)";5936;5947;5961;5879;1288;1285;1259;1201;3793;3760;3759;3701;2418;2421;2441;2399;1375;1339;1318;1302;855;902;943;977;
3022023;"Jutrosin (3)";7119;7113;7146;7105;1619;1612;1635;1586;4430;4408;4383;4362;2912;2891;2873;2867;1518;1517;1510;1495;1070;1093;1128;1157;
3022024;"Jutrosin - miasto (4)";1924;1946;1928;1932;397;406;391;395;1201;1204;1183;1173;766;781;770;768;435;423;413;405;326;336;354;364;
3022025;"Jutrosin - obszar wiejski (5)";5195;5167;5218;5173;1222;1206;1244;1191;3229;3204;3200;3189;2146;2110;2103;2099;1083;1094;1097;1090;744;757;774;793;
3022033;"Miejska Górka (3)";9377;9380;9402;9389;1992;1974;1980;1968;5920;5875;5851;5801;3789;3780;3783;3764;2131;2095;2068;2037;1465;1531;1571;1620;
3022034;"Miejska Górka - miasto (4)";3239;3246;3253;3274;642;638;636;643;2099;2080;2078;2068;1312;1303;1299;1297;787;777;779;771;498;528;539;563;
3022035;"Miejska Górka - obszar wiejski (5)";6138;6134;6149;6115;1350;1336;1344;1325;3821;3795;3773;3733;2477;2477;2484;2467;1344;1318;1289;1266;967;1003;1032;1057;
3022042;"Pakosław (2)";4749;4768;4785;4799;1102;1088;1086;1089;2944;2927;2931;2937;1884;1907;1931;1932;1060;1020;1000;1005;703;753;768;773;
3022053;"Rawicz (3)";30244;30215;30200;30170;5908;5875;5824;5737;19265;19041;18871;18743;12206;12119;12037;12012;7059;6922;6834;6731;5071;5299;5505;5690;
3022054;"Rawicz - miasto (4)";20994;20846;20779;20608;3765;3728;3690;3622;13365;13100;12916;12682;8284;8157;8073;7953;5081;4943;4843;4729;3864;4018;4173;4304;
3022055;"Rawicz - obszar wiejski (5)";9250;9369;9421;9562;2143;2147;2134;2115;5900;5941;5955;6061;3922;3962;3964;4059;1978;1979;1991;2002;1207;1281;1332;1386;
3023011;"Słupca (1)";14063;14019;14016;13933;2395;2385;2366;2328;9179;8984;8851;8655;5593;5549;5522;5420;3586;3435;3329;3235;2489;2650;2799;2950;
3023022;"Lądek (2)";5740;5764;5762;5774;1120;1114;1086;1081;3626;3636;3625;3620;2338;2339;2343;2340;1288;1297;1282;1280;994;1014;1051;1073;
3023032;"Orchowo (2)";3943;3929;3918;3912;833;809;798;790;2499;2488;2461;2433;1585;1580;1571;1558;914;908;890;875;611;632;659;689;
3023042;"Ostrowite (2)";5155;5165;5196;5152;1081;1056;1057;999;3242;3247;3251;3245;2046;2056;2072;2088;1196;1191;1179;1157;832;862;888;908;
3023052;"Powidz (2)";2218;2214;2278;2290;386;372;378;390;1413;1393;1437;1434;906;904;942;931;507;489;495;503;419;449;463;466;
3023062;"Słupca (2)";9256;9173;9087;9108;1951;1882;1812;1791;5815;5798;5767;5795;3824;3793;3725;3727;1991;2005;2042;2068;1490;1493;1508;1522;
3023072;"Strzałkowo (2)";10232;10256;10326;10336;2141;2092;2075;2078;6622;6622;6650;6624;4281;4307;4314;4287;2341;2315;2336;2337;1469;1542;1601;1634;
3023083;"Zagórów (3)";9147;9131;9115;9086;1888;1848;1827;1795;5808;5803;5756;5754;3696;3692;3655;3631;2112;2111;2101;2123;1451;1480;1532;1537;
3023084;"Zagórów - miasto (4)";3054;3065;3076;3065;586;572;585;588;2007;2013;1993;1974;1261;1274;1256;1236;746;739;737;738;461;480;498;503;
3023085;"Zagórów - obszar wiejski (5)";6093;6066;6039;6021;1302;1276;1242;1207;3801;3790;3763;3780;2435;2418;2399;2395;1366;1372;1364;1385;990;1000;1034;1034;
3024011;"Obrzycko (1)";2359;2384;2393;2395;465;468;466;462;1556;1567;1562;1544;1021;1026;1022;1026;535;541;540;518;338;349;365;389;
3024022;"Duszniki (2)";8582;8638;8681;8726;1851;1842;1825;1857;5542;5577;5617;5557;3566;3587;3600;3579;1976;1990;2017;1978;1189;1219;1239;1312;
3024032;"Kaźmierz (2)";7875;7965;8093;8176;1715;1746;1744;1721;5060;5094;5173;5255;3343;3352;3408;3450;1717;1742;1765;1805;1100;1125;1176;1200;
3024042;"Obrzycko (2)";4417;4430;4479;4467;927;920;912;893;2848;2856;2889;2853;1844;1844;1870;1856;1004;1012;1019;997;642;654;678;721;
3024053;"Ostroróg (3)";4972;4988;5041;5004;1027;1029;1056;1022;3214;3211;3197;3177;2057;2052;2043;2025;1157;1159;1154;1152;731;748;788;805;
3024054;"Ostroróg - miasto (4)";1983;1988;1989;1968;379;379;377;364;1291;1285;1271;1255;802;804;782;767;489;481;489;488;313;324;341;349;
3024055;"Ostroróg - obszar wiejski (5)";2989;3000;3052;3036;648;650;679;658;1923;1926;1926;1922;1255;1248;1261;1258;668;678;665;664;418;424;447;456;
3024063;"Pniewy (3)";12506;12496;12550;12567;2603;2596;2602;2606;8163;8094;8017;7962;5265;5231;5216;5197;2898;2863;2801;2765;1740;1806;1931;1999;
3024064;"Pniewy - miasto (4)";7959;7953;7982;8022;1625;1625;1638;1642;5219;5177;5094;5087;3340;3329;3290;3290;1879;1848;1804;1797;1115;1151;1250;1293;
3024065;"Pniewy - obszar wiejski (5)";4547;4543;4568;4545;978;971;964;964;2944;2917;2923;2875;1925;1902;1926;1907;1019;1015;997;968;625;655;681;706;
3024073;"Szamotuły (3)";29546;29656;29607;29722;5705;5701;5665;5741;19025;18924;18726;18612;12141;12102;11985;11922;6884;6822;6741;6690;4816;5031;5216;5369;
3024074;"Szamotuły - miasto (4)";19001;19020;18831;18817;3418;3414;3336;3381;12131;11998;11744;11592;7645;7586;7422;7322;4486;4412;4322;4270;3452;3608;3751;3844;
3024075;"Szamotuły - obszar wiejski (5)";10545;10636;10776;10905;2287;2287;2329;2360;6894;6926;6982;7020;4496;4516;4563;4600;2398;2410;2419;2420;1364;1423;1465;1525;
3024083;"Wronki (3)";19058;19051;19078;19076;3680;3678;3689;3669;12281;12124;12026;11896;7786;7710;7660;7603;4495;4414;4366;4293;3097;3249;3363;3511;
3024084;"Wronki - miasto (4)";11615;11549;11473;11381;2074;2080;2062;2033;7519;7335;7195;7045;4720;4602;4517;4425;2799;2733;2678;2620;2022;2134;2216;2303;
3024085;"Wronki - obszar wiejski (5)";7443;7502;7605;7695;1606;1598;1627;1636;4762;4789;4831;4851;3066;3108;3143;3178;1696;1681;1688;1673;1075;1115;1147;1208;
3025012;"Dominowo (2)";2995;3001;2997;3004;656;671;670;677;1948;1932;1920;1918;1282;1265;1259;1255;666;667;661;663;391;398;407;409;
3025022;"Krzykosy (2)";6725;6819;6853;6921;1446;1472;1451;1460;4336;4357;4389;4411;2794;2820;2832;2873;1542;1537;1557;1538;943;990;1013;1050;
3025032;"Nowe Miasto nad Wartą (2)";9143;9100;9101;9146;1941;1894;1879;1862;5876;5840;5798;5820;3808;3776;3737;3734;2068;2064;2061;2086;1326;1366;1424;1464;
3025043;"Środa Wielkopolska (3)";31114;31275;31426;31591;5986;6020;6050;6097;20260;20182;20093;19980;12795;12854;12867;12863;7465;7328;7226;7117;4868;5073;5283;5514;
3025044;"Środa Wielkopolska - miasto (4)";22425;22572;22661;22740;4181;4248;4270;4328;14586;14505;14411;14276;9198;9218;9188;9140;5388;5287;5223;5136;3658;3819;3980;4136;
3025045;"Środa Wielkopolska - obszar wiejski (5)";8689;8703;8765;8851;1805;1772;1780;1769;5674;5677;5682;5704;3597;3636;3679;3723;2077;2041;2003;1981;1210;1254;1303;1378;
3025052;"Zaniemyśl (2)";6676;6730;6779;6767;1386;1382;1362;1382;4320;4350;4382;4299;2777;2794;2814;2774;1543;1556;1568;1525;970;998;1035;1086;
3026012;"Brodnica (2)";4943;4914;4923;4906;1084;1063;1069;1041;3237;3199;3180;3155;2086;2062;2026;2022;1151;1137;1154;1133;622;652;674;710;
3026023;"Dolsk (3)";5890;5853;5891;5899;1287;1237;1254;1269;3719;3713;3728;3702;2421;2397;2409;2390;1298;1316;1319;1312;884;903;909;928;
3026024;"Dolsk - miasto (4)";1550;1560;1575;1571;333;333;324;316;953;955;979;983;610;612;628;627;343;343;351;356;264;272;272;272;
3026025;"Dolsk - obszar wiejski (5)";4340;4293;4316;4328;954;904;930;953;2766;2758;2749;2719;1811;1785;1781;1763;955;973;968;956;620;631;637;656;
3026033;"Książ Wielkopolski (3)";8553;8580;8592;8579;1937;1920;1919;1891;5502;5514;5500;5466;3533;3548;3527;3503;1969;1966;1973;1963;1114;1146;1173;1222;
3026034;"Książ Wielkopolski - miasto (4)";2778;2780;2776;2763;586;585;577;567;1852;1838;1825;1805;1157;1154;1133;1121;695;684;692;684;340;357;374;391;
3026035;"Książ Wielkopolski - obszar wiejski (5)";5775;5800;5816;5816;1351;1335;1342;1324;3650;3676;3675;3661;2376;2394;2394;2382;1274;1282;1281;1279;774;789;799;831;
3026043;"Śrem (3)";41405;41378;41389;41523;8205;8112;8052;8110;26871;26587;26345;26065;17074;16938;16848;16728;9797;9649;9497;9337;6329;6679;6992;7348;
3026044;"Śrem - miasto (4)";30350;30152;30036;29983;5700;5607;5549;5594;19680;19303;18989;18612;12375;12169;12009;11815;7305;7134;6980;6797;4970;5242;5498;5777;
3026045;"Śrem - obszar wiejski (5)";11055;11226;11353;11540;2505;2505;2503;2516;7191;7284;7356;7453;4699;4769;4839;4913;2492;2515;2517;2540;1359;1437;1494;1571;
3027011;"Turek (1)";28655;28100;27926;27743;4819;4644;4610;4564;18503;17940;17589;17263;11136;10799;10601;10388;7367;7141;6988;6875;5333;5516;5727;5916;
3027022;"Brudzew (2)";5998;5958;5977;5956;1252;1225;1209;1181;3734;3719;3722;3718;2445;2438;2443;2433;1289;1281;1279;1285;1012;1014;1046;1057;
3027033;"Dobra (3)";6321;6292;6269;6240;1201;1184;1176;1176;3927;3888;3864;3813;2403;2374;2341;2325;1524;1514;1523;1488;1193;1220;1229;1251;
3027034;"Dobra - miasto (4)";1453;1454;1427;1416;249;254;240;241;955;943;924;894;587;585;560;539;368;358;364;355;249;257;263;281;
3027035;"Dobra - obszar wiejski (5)";4868;4838;4842;4824;952;930;936;935;2972;2945;2940;2919;1816;1789;1781;1786;1156;1156;1159;1133;944;963;966;970;
3027042;"Kawęczyn (2)";5265;5248;5239;5219;1105;1104;1072;1053;3245;3230;3232;3238;2108;2104;2098;2090;1137;1126;1134;1148;915;914;935;928;
3027052;"Malanów (2)";6515;6523;6532;6540;1458;1419;1395;1372;4090;4121;4133;4155;2754;2764;2775;2771;1336;1357;1358;1384;967;983;1004;1013;
3027062;"Przykona (2)";4391;4405;4428;4447;945;925;895;902;2739;2751;2786;2797;1824;1819;1850;1844;915;932;936;953;707;729;747;748;
3027073;"Tuliszków (3)";10607;10671;10670;10693;2210;2222;2211;2182;6881;6883;6832;6831;4430;4452;4406;4411;2451;2431;2426;2420;1516;1566;1627;1680;
3027074;"Tuliszków - miasto (4)";3405;3405;3379;3367;630;635;627;622;2333;2304;2259;2226;1434;1421;1385;1368;899;883;874;858;442;466;493;519;
3027075;"Tuliszków - obszar wiejski (5)";7202;7266;7291;7326;1580;1587;1584;1560;4548;4579;4573;4605;2996;3031;3021;3043;1552;1548;1552;1562;1074;1100;1134;1161;
3027082;"Turek (2)";8799;9080;9248;9353;2074;2105;2138;2110;5570;5784;5891;5990;3665;3779;3819;3885;1905;2005;2072;2105;1155;1191;1219;1253;
3027092;"Władysławów (2)";8079;8143;8152;8175;1801;1791;1732;1737;5173;5214;5248;5239;3411;3452;3447;3418;1762;1762;1801;1821;1105;1138;1172;1199;
3028011;"Wągrowiec (1)";25276;25178;25266;25295;4796;4755;4734;4702;16278;16061;15985;15883;10249;10094;10090;10048;6029;5967;5895;5835;4202;4362;4547;4710;
3028022;"Damasławek (2)";5603;5600;5566;5558;1193;1164;1157;1150;3554;3533;3489;3462;2211;2212;2205;2200;1343;1321;1284;1262;856;903;920;946;
3028033;"Gołańcz (3)";8566;8547;8519;8417;1999;1955;1888;1861;5352;5353;5342;5255;3406;3427;3451;3364;1946;1926;1891;1891;1215;1239;1289;1301;
3028034;"Gołańcz - miasto (4)";3431;3413;3397;3356;769;754;705;691;2172;2154;2150;2110;1355;1350;1378;1339;817;804;772;771;490;505;542;555;
3028035;"Gołańcz - obszar wiejski (5)";5135;5134;5122;5061;1230;1201;1183;1170;3180;3199;3192;3145;2051;2077;2073;2025;1129;1122;1119;1120;725;734;747;746;
3028042;"Mieścisko (2)";6071;6074;6097;6065;1371;1344;1351;1317;3842;3842;3843;3820;2490;2489;2481;2442;1352;1353;1362;1378;858;888;903;928;
3028053;"Skoki (3)";9235;9283;9341;9384;2002;1961;1958;1966;6017;6065;6087;6094;3880;3929;3954;3941;2137;2136;2133;2153;1216;1257;1296;1324;
3028054;"Skoki - miasto (4)";4146;4145;4175;4187;876;860;861;878;2757;2732;2740;2711;1752;1752;1770;1759;1005;980;970;952;513;553;574;598;
3028055;"Skoki - obszar wiejski (5)";5089;5138;5166;5197;1126;1101;1097;1088;3260;3333;3347;3383;2128;2177;2184;2182;1132;1156;1163;1201;703;704;722;726;
3028062;"Wapno (2)";3102;3096;3050;3039;631;625;617;608;1983;1958;1918;1898;1208;1202;1178;1173;775;756;740;725;488;513;515;533;
3028072;"Wągrowiec (2)";11922;12059;12048;12142;2773;2768;2729;2761;7631;7712;7687;7668;4949;5048;5035;5049;2682;2664;2652;2619;1518;1579;1632;1713;
3029012;"Przemęt (2)";13884;13874;13980;14015;3080;3019;3021;3013;8875;8834;8839;8791;5747;5722;5723;5689;3128;3112;3116;3102;1929;2021;2120;2211;
3029022;"Siedlec (2)";12444;12522;12533;12597;2835;2831;2813;2816;7935;7945;7889;7866;5197;5236;5226;5195;2738;2709;2663;2671;1674;1746;1831;1915;
3029033;"Wolsztyn (3)";30365;30384;30466;30400;6302;6243;6164;6079;19237;19132;19082;18955;12429;12390;12351;12232;6808;6742;6731;6723;4826;5009;5220;5366;
3029034;"Wolsztyn - miasto (4)";13662;13586;13552;13359;2415;2404;2382;2347;8660;8482;8360;8145;5410;5316;5253;5100;3250;3166;3107;3045;2587;2700;2810;2867;
3029035;"Wolsztyn - obszar wiejski (5)";16703;16798;16914;17041;3887;3839;3782;3732;10577;10650;10722;10810;7019;7074;7098;7132;3558;3576;3624;3678;2239;2309;2410;2499;
3030012;"Kołaczkowo (2)";6114;6102;6124;6060;1359;1326;1322;1300;3965;3954;3943;3900;2535;2540;2523;2495;1430;1414;1420;1405;790;822;859;860;
3030023;"Miłosław (3)";10385;10350;10356;10372;2034;2023;2026;2009;6747;6664;6593;6566;4247;4209;4175;4180;2500;2455;2418;2386;1604;1663;1737;1797;
3030024;"Miłosław - miasto (4)";3627;3626;3589;3586;686;691;672;652;2371;2343;2298;2299;1479;1470;1429;1434;892;873;869;865;570;592;619;635;
3030025;"Miłosław - obszar wiejski (5)";6758;6724;6767;6786;1348;1332;1354;1357;4376;4321;4295;4267;2768;2739;2746;2746;1608;1582;1549;1521;1034;1071;1118;1162;
3030033;"Nekla (3)";7191;7264;7327;7406;1518;1530;1538;1524;4763;4760;4761;4817;3077;3057;3062;3088;1686;1703;1699;1729;910;974;1028;1065;
3030034;"Nekla - miasto (4)";3599;3621;3655;3692;751;752;755;738;2389;2374;2376;2415;1559;1535;1545;1558;830;839;831;857;459;495;524;539;
3030035;"Nekla - obszar wiejski (5)";3592;3643;3672;3714;767;778;783;786;2374;2386;2385;2402;1518;1522;1517;1530;856;864;868;872;451;479;504;526;
3030043;"Pyzdry (3)";7240;7218;7202;7166;1481;1443;1428;1397;4555;4529;4496;4471;2958;2921;2895;2877;1597;1608;1601;1594;1204;1246;1278;1298;
3030044;"Pyzdry - miasto (4)";3255;3234;3220;3207;633;613;616;595;2091;2065;2033;2019;1326;1296;1273;1263;765;769;760;756;531;556;571;593;
3030045;"Pyzdry - obszar wiejski (5)";3985;3984;3982;3959;848;830;812;802;2464;2464;2463;2452;1632;1625;1622;1614;832;839;841;838;673;690;707;705;
3030053;"Września (3)";45523;45547;45820;45952;8960;8916;8963;8968;29111;28919;28809;28612;18478;18427;18446;18373;10633;10492;10363;10239;7452;7712;8048;8372;
3030054;"Września - miasto (4)";29564;29552;29735;29858;5457;5434;5506;5520;18820;18646;18507;18362;11829;11781;11749;11721;6991;6865;6758;6641;5287;5472;5722;5976;
3030055;"Września - obszar wiejski (5)";15959;15995;16085;16094;3503;3482;3457;3448;10291;10273;10302;10250;6649;6646;6697;6652;3642;3627;3605;3598;2165;2240;2326;2396;
3031011;"Złotów (1)";18757;18593;18492;18440;3449;3363;3293;3223;12237;11997;11792;11650;7603;7452;7371;7330;4634;4545;4421;4320;3071;3233;3407;3567;
3031023;"Jastrowie (3)";11717;11675;11716;11630;2454;2371;2346;2312;7535;7503;7454;7357;4678;4691;4678;4633;2857;2812;2776;2724;1728;1801;1916;1961;
3031024;"Jastrowie - miasto (4)";8666;8664;8703;8675;1807;1766;1754;1748;5552;5530;5486;5420;3444;3469;3468;3446;2108;2061;2018;1974;1307;1368;1463;1507;
3031025;"Jastrowie - obszar wiejski (5)";3051;3011;3013;2955;647;605;592;564;1983;1973;1968;1937;1234;1222;1210;1187;749;751;758;750;421;433;453;454;
3031033;"Krajenka (3)";7531;7564;7612;7560;1616;1616;1592;1545;4916;4880;4920;4879;3086;3105;3125;3116;1830;1775;1795;1763;999;1068;1100;1136;
3031034;"Krajenka - miasto (4)";3798;3811;3797;3731;726;729;700;667;2512;2472;2470;2429;1540;1538;1538;1510;972;934;932;919;560;610;627;635;
3031035;"Krajenka - obszar wiejski (5)";3733;3753;3815;3829;890;887;892;878;2404;2408;2450;2450;1546;1567;1587;1606;858;841;863;844;439;458;473;501;
3031042;"Lipka (2)";5673;5658;5638;5617;1262;1217;1194;1167;3647;3646;3615;3593;2296;2318;2304;2298;1351;1328;1311;1295;764;795;829;857;
3031053;"Okonek (3)";8995;8877;8826;8793;1832;1773;1743;1700;5738;5673;5615;5564;3588;3537;3488;3469;2150;2136;2127;2095;1425;1431;1468;1529;
3031054;"Okonek - miasto (4)";4030;3981;3979;3973;811;787;792;780;2546;2522;2510;2476;1565;1547;1542;1533;981;975;968;943;673;672;677;717;
3031055;"Okonek - obszar wiejski (5)";4965;4896;4847;4820;1021;986;951;920;3192;3151;3105;3088;2023;1990;1946;1936;1169;1161;1159;1152;752;759;791;812;
3031062;"Tarnówka (2)";3134;3105;3122;3105;696;668;662;643;1986;1973;1973;1958;1264;1276;1287;1283;722;697;686;675;452;464;487;504;
3031072;"Zakrzewo (2)";4956;4938;4934;4928;1079;1041;1011;980;3206;3220;3232;3241;2065;2062;2072;2082;1141;1158;1160;1159;671;677;691;707;
3031082;"Złotów (2)";9509;9591;9658;9708;2174;2192;2177;2152;6224;6243;6266;6303;4061;4089;4127;4155;2163;2154;2139;2148;1111;1156;1215;1253;
3061011;"Kalisz (1)";104676;103997;103373;102808;17895;17648;17431;17272;64872;63732;62665;61682;39745;39233;38664;38092;25127;24499;24001;23590;21909;22617;23277;23854;
3062011;"Konin (1)";77847;77224;76547;75875;12841;12520;12220;11943;49626;48643;47665;46679;30493;29876;29296;28605;19133;18767;18369;18074;15380;16061;16662;17253;
3063011;"Leszno (1)";64722;64589;64616;64559;11853;11822;11813;11740;41387;40692;40184;39613;25893;25578;25392;25193;15494;15114;14792;14420;11482;12075;12619;13206;
3064011;"Poznań (1)";550742;548028;545680;542348;84664;84968;85668;86233;352652;346120;339667;332702;228065;225951;223295;219545;124587;120169;116372;113157;113426;116940;120345;123413;
3201011;"Białogard (1)";24794;24722;24571;24437;4476;4358;4280;4192;15971;15854;15567;15314;9857;9827;9681;9547;6114;6027;5886;5767;4347;4510;4724;4931;
3201022;"Białogard (2)";7984;7853;7833;7818;1609;1520;1473;1461;5300;5238;5223;5198;3363;3316;3357;3307;1937;1922;1866;1891;1075;1095;1137;1159;
3201033;"Karlino (3)";9347;9307;9316;9267;1945;1909;1895;1852;6065;6009;5974;5905;3773;3780;3770;3752;2292;2229;2204;2153;1337;1389;1447;1510;
3201034;"Karlino - miasto (4)";6005;5974;5989;5935;1211;1174;1173;1151;3903;3864;3824;3735;2430;2426;2419;2377;1473;1438;1405;1358;891;936;992;1049;
3201035;"Karlino - obszar wiejski (5)";3342;3333;3327;3332;734;735;722;701;2162;2145;2150;2170;1343;1354;1351;1375;819;791;799;795;446;453;455;461;
3201043;"Tychowo (3)";7059;7017;6959;6926;1511;1504;1451;1401;4518;4480;4453;4428;2812;2783;2772;2772;1706;1697;1681;1656;1030;1033;1055;1097;
3201044;"Tychowo - miasto (4)";2542;2533;2555;2539;544;569;585;564;1625;1588;1579;1560;1011;976;971;966;614;612;608;594;373;376;391;415;
3201045;"Tychowo - obszar wiejski (5)";4517;4484;4404;4387;967;935;866;837;2893;2892;2874;2868;1801;1807;1801;1806;1092;1085;1073;1062;657;657;664;682;
3202012;"Bierzwnik (2)";4849;4828;4804;4785;912;878;870;857;3106;3085;3050;3001;1920;1918;1876;1858;1186;1167;1174;1143;831;865;884;927;
3202023;"Choszczno (3)";22402;22340;22265;22096;4195;4107;4038;3934;14604;14459;14245;13991;8976;8946;8900;8755;5628;5513;5345;5236;3603;3774;3982;4171;
3202024;"Choszczno - miasto (4)";15800;15716;15575;15526;2723;2665;2594;2556;10371;10203;9954;9769;6257;6200;6109;6030;4114;4003;3845;3739;2706;2848;3027;3201;
3202025;"Choszczno - obszar wiejski (5)";6602;6624;6690;6570;1472;1442;1444;1378;4233;4256;4291;4222;2719;2746;2791;2725;1514;1510;1500;1497;897;926;955;970;
3202033;"Drawno (3)";5299;5236;5222;5177;916;880;875;848;3522;3476;3423;3386;2102;2070;2029;2007;1420;1406;1394;1379;861;880;924;943;
3202034;"Drawno - miasto (4)";2364;2335;2340;2304;393;371;375;357;1557;1536;1515;1493;919;908;886;871;638;628;629;622;414;428;450;454;
3202035;"Drawno - obszar wiejski (5)";2935;2901;2882;2873;523;509;500;491;1965;1940;1908;1893;1183;1162;1143;1136;782;778;765;757;447;452;474;489;
3202042;"Krzęcin (2)";3856;3831;3799;3811;731;698;682;685;2540;2534;2503;2502;1547;1556;1545;1537;993;978;958;965;585;599;614;624;
3202053;"Pełczyce (3)";8037;8001;7964;7946;1627;1611;1576;1574;5229;5178;5129;5081;3290;3263;3229;3196;1939;1915;1900;1885;1181;1212;1259;1291;
3202054;"Pełczyce - miasto (4)";2682;2653;2635;2639;458;442;431;441;1819;1807;1777;1753;1126;1109;1087;1067;693;698;690;686;405;404;427;445;
3202055;"Pełczyce - obszar wiejski (5)";5355;5348;5329;5307;1169;1169;1145;1133;3410;3371;3352;3328;2164;2154;2142;2129;1246;1217;1210;1199;776;808;832;846;
3202063;"Recz (3)";5717;5693;5655;5659;1124;1080;1041;1038;3746;3722;3687;3676;2313;2310;2311;2294;1433;1412;1376;1382;847;891;927;945;
3202064;"Recz - miasto (4)";2973;2977;2955;2962;542;526;512;516;1971;1965;1939;1938;1206;1216;1211;1202;765;749;728;736;460;486;504;508;
3202065;"Recz - obszar wiejski (5)";2744;2716;2700;2697;582;554;529;522;1775;1757;1748;1738;1107;1094;1100;1092;668;663;648;646;387;405;423;437;
3203013;"Czaplinek (3)";11947;11950;12028;11942;2383;2366;2384;2292;7711;7637;7581;7501;4649;4652;4702;4666;3062;2985;2879;2835;1853;1947;2063;2149;
3203014;"Czaplinek - miasto (4)";7200;7188;7201;7158;1388;1379;1354;1321;4635;4563;4533;4469;2740;2725;2756;2727;1895;1838;1777;1742;1177;1246;1314;1368;
3203015;"Czaplinek - obszar wiejski (5)";4747;4762;4827;4784;995;987;1030;971;3076;3074;3048;3032;1909;1927;1946;1939;1167;1147;1102;1093;676;701;749;781;
3203023;"Drawsko Pomorskie (3)";16744;16618;16534;16437;3146;3045;2998;2928;10819;10686;10495;10352;6522;6492;6446;6405;4297;4194;4049;3947;2779;2887;3041;3157;
3203024;"Drawsko Pomorskie - miasto (4)";11895;11878;11828;11781;2155;2113;2088;2068;7729;7655;7503;7383;4645;4642;4608;4573;3084;3013;2895;2810;2011;2110;2237;2330;
3203025;"Drawsko Pomorskie - obszar wiejski (5)";4849;4740;4706;4656;991;932;910;860;3090;3031;2992;2969;1877;1850;1838;1832;1213;1181;1154;1137;768;777;804;827;
3203033;"Kalisz Pomorski (3)";7376;7383;7365;7349;1561;1593;1579;1578;4714;4652;4622;4563;2960;2915;2905;2882;1754;1737;1717;1681;1101;1138;1164;1208;
3203034;"Kalisz Pomorski - miasto (4)";4333;4361;4356;4391;891;926;929;946;2763;2724;2684;2671;1699;1669;1656;1660;1064;1055;1028;1011;679;711;743;774;
3203035;"Kalisz Pomorski - obszar wiejski (5)";3043;3022;3009;2958;670;667;650;632;1951;1928;1938;1892;1261;1246;1249;1222;690;682;689;670;422;427;421;434;
3203042;"Ostrowice (2)";2653;2595;2567;2571;578;545;531;512;1697;1659;1617;1618;1063;1035;1008;1030;634;624;609;588;378;391;419;441;
3203052;"Wierzchowo (2)";4421;4372;4358;4353;846;798;800;784;2888;2868;2817;2791;1681;1688;1663;1684;1207;1180;1154;1107;687;706;741;778;
3203063;"Złocieniec (3)";15583;15485;15412;15410;2768;2673;2636;2626;10253;10165;10035;9908;6143;6139;6078;6064;4110;4026;3957;3844;2562;2647;2741;2876;
3203064;"Złocieniec - miasto (4)";13331;13224;13190;13190;2364;2280;2278;2282;8766;8658;8538;8434;5280;5268;5215;5198;3486;3390;3323;3236;2201;2286;2374;2474;
3203065;"Złocieniec - obszar wiejski (5)";2252;2261;2222;2220;404;393;358;344;1487;1507;1497;1474;863;871;863;866;624;636;634;608;361;361;367;402;
3204023;"Goleniów (3)";35381;35533;35709;35716;6890;6877;6877;6807;23084;22957;22861;22637;14317;14346;14359;14275;8767;8611;8502;8362;5407;5699;5971;6272;
3204024;"Goleniów - miasto (4)";22846;22776;22747;22578;4103;4084;4067;3979;14696;14461;14254;13991;9089;9032;8982;8859;5607;5429;5272;5132;4047;4231;4426;4608;
3204025;"Goleniów - obszar wiejski (5)";12535;12757;12962;13138;2787;2793;2810;2828;8388;8496;8607;8646;5228;5314;5377;5416;3160;3182;3230;3230;1360;1468;1545;1664;
3204033;"Maszewo (3)";8696;8717;8786;8789;1943;1882;1861;1816;5568;5594;5645;5655;3598;3658;3691;3704;1970;1936;1954;1951;1185;1241;1280;1318;
3204034;"Maszewo - miasto (4)";3336;3337;3374;3371;750;727;707;674;2099;2088;2137;2146;1364;1379;1420;1435;735;709;717;711;487;522;530;551;
3204035;"Maszewo - obszar wiejski (5)";5360;5380;5412;5418;1193;1155;1154;1142;3469;3506;3508;3509;2234;2279;2271;2269;1235;1227;1237;1240;698;719;750;767;
3204043;"Nowogard (3)";24958;24955;24894;24763;4742;4656;4613;4537;16333;16202;15967;15688;10061;10074;9971;9809;6272;6128;5996;5879;3883;4097;4314;4538;
3204044;"Nowogard - miasto (4)";16974;16937;16821;16751;2891;2846;2807;2775;11213;11053;10793;10571;6718;6700;6581;6476;4495;4353;4212;4095;2870;3038;3221;3405;
3204045;"Nowogard - obszar wiejski (5)";7984;8018;8073;8012;1851;1810;1806;1762;5120;5149;5174;5117;3343;3374;3390;3333;1777;1775;1784;1784;1013;1059;1093;1133;
3204052;"Osina (2)";2989;3002;3019;3037;654;638;632;634;1904;1926;1937;1940;1226;1237;1240;1235;678;689;697;705;431;438;450;463;
3204062;"Przybiernów (2)";5185;5206;5134;5119;1026;1011;959;949;3394;3401;3365;3333;2061;2089;2076;2066;1333;1312;1289;1267;765;794;810;837;
3204072;"Stepnica (2)";4858;4857;;;960;935;;;3226;3210;;;1982;1967;;;1244;1243;;;672;712;;;
3204073;"Stepnica (3)";;;4965;4931;;;960;936;;;3268;3249;;;2032;2024;;;1236;1225;;;737;746;
3204074;"Stepnica - miasto (4)";;;2446;2441;;;494;491;;;1580;1580;;;1007;1009;;;573;571;;;372;370;
3204075;"Stepnica - obszar wiejski (5)";;;2519;2490;;;466;445;;;1688;1669;;;1025;1015;;;663;654;;;365;376;
3205012;"Brojce (2)";3842;3829;3831;3843;861;844;837;848;2478;2448;2440;2429;1561;1562;1573;1568;917;886;867;861;503;537;554;566;
3205023;"Gryfice (3)";24095;24013;24031;23945;4500;4414;4322;4270;15682;15513;15398;15176;9432;9406;9428;9383;6250;6107;5970;5793;3913;4086;4311;4499;
3205024;"Gryfice - miasto (4)";17016;16898;16853;16725;2949;2872;2809;2768;11032;10850;10692;10460;6541;6503;6482;6412;4491;4347;4210;4048;3035;3176;3352;3497;
3205025;"Gryfice - obszar wiejski (5)";7079;7115;7178;7220;1551;1542;1513;1502;4650;4663;4706;4716;2891;2903;2946;2971;1759;1760;1760;1745;878;910;959;1002;
3205032;"Karnice (2)";4246;4216;4140;4100;851;826;782;748;2780;2757;2699;2670;1707;1688;1663;1651;1073;1069;1036;1019;615;633;659;682;
3205043;"Płoty (3)";9166;9144;9088;9027;1943;1912;1850;1807;5962;5918;5866;5814;3703;3693;3697;3651;2259;2225;2169;2163;1261;1314;1372;1406;
3205044;"Płoty - miasto (4)";4080;4092;4048;4020;751;745;714;682;2677;2649;2599;2584;1591;1611;1598;1607;1086;1038;1001;977;652;698;735;754;
3205045;"Płoty - obszar wiejski (5)";5086;5052;5040;5007;1192;1167;1136;1125;3285;3269;3267;3230;2112;2082;2099;2044;1173;1187;1168;1186;609;616;637;652;
3205072;"Rewal (2)";3778;3817;3846;3891;673;678;674;676;2453;2461;2444;2438;1457;1458;1455;1474;996;1003;989;964;652;678;728;777;
3205083;"Trzebiatów (3)";16671;16653;16581;16565;3108;3022;2938;2897;11022;11038;10946;10831;6667;6707;6644;6605;4355;4331;4302;4226;2541;2593;2697;2837;
3205084;"Trzebiatów - miasto (4)";10250;10202;10153;10145;1870;1816;1778;1749;6747;6720;6643;6582;4049;4053;4008;3983;2698;2667;2635;2599;1633;1666;1732;1814;
3205085;"Trzebiatów - obszar wiejski (5)";6421;6451;6428;6420;1238;1206;1160;1148;4275;4318;4303;4249;2618;2654;2636;2622;1657;1664;1667;1627;908;927;965;1023;
3206012;"Banie (2)";6502;6473;6442;6441;1304;1265;1238;1217;4260;4235;4184;4137;2594;2605;2633;2612;1666;1630;1551;1525;938;973;1020;1087;
3206023;"Cedynia (3)";4434;4405;4362;4350;884;838;810;787;2911;2899;2850;2849;1760;1766;1758;1775;1151;1133;1092;1074;639;668;702;714;
3206024;"Cedynia - miasto (4)";1685;1651;1631;1649;329;298;284;281;1148;1134;1110;1116;679;678;678;689;469;456;432;427;208;219;237;252;
3206025;"Cedynia - obszar wiejski (5)";2749;2754;2731;2701;555;540;526;506;1763;1765;1740;1733;1081;1088;1080;1086;682;677;660;647;431;449;465;462;
3206033;"Chojna (3)";14057;13969;13937;13912;2757;2661;2613;2576;9198;9176;9125;9047;5637;5657;5615;5548;3561;3519;3510;3499;2102;2132;2199;2289;
3206034;"Chojna - miasto (4)";7353;7303;7382;7403;1415;1356;1349;1341;4847;4831;4838;4818;3015;3025;3019;3007;1832;1806;1819;1811;1091;1116;1195;1244;
3206035;"Chojna - obszar wiejski (5)";6704;6666;6555;6509;1342;1305;1264;1235;4351;4345;4287;4229;2622;2632;2596;2541;1729;1713;1691;1688;1011;1016;1004;1045;
3206043;"Gryfino (3)";32177;32147;32178;32117;5946;5860;5801;5768;21328;21058;20814;20440;13046;13038;13021;12895;8282;8020;7793;7545;4903;5229;5563;5909;
3206044;"Gryfino - miasto (4)";21589;21578;21565;21450;3775;3759;3736;3701;14343;14095;13849;13508;8634;8623;8577;8478;5709;5472;5272;5030;3471;3724;3980;4241;
3206045;"Gryfino - obszar wiejski (5)";10588;10569;10613;10667;2171;2101;2065;2067;6985;6963;6965;6932;4412;4415;4444;4417;2573;2548;2521;2515;1432;1505;1583;1668;
3206053;"Mieszkowice (3)";7426;7415;7413;7380;1463;1443;1452;1412;4869;4858;4815;4783;3047;3049;3026;3008;1822;1809;1789;1775;1094;1114;1146;1185;
3206054;"Mieszkowice - miasto (4)";3609;3603;3594;3592;688;697;697;691;2404;2387;2354;2347;1502;1502;1478;1466;902;885;876;881;517;519;543;554;
3206055;"Mieszkowice - obszar wiejski (5)";3817;3812;3819;3788;775;746;755;721;2465;2471;2461;2436;1545;1547;1548;1542;920;924;913;894;577;595;603;631;
3206063;"Moryń (3)";4401;4370;4362;4340;838;808;812;798;2931;2888;2848;2817;1765;1758;1754;1733;1166;1130;1094;1084;632;674;702;725;
3206064;"Moryń - miasto (4)";1631;1600;1608;1611;267;253;258;257;1101;1070;1056;1047;659;641;637;633;442;429;419;414;263;277;294;307;
3206065;"Moryń - obszar wiejski (5)";2770;2770;2754;2729;571;555;554;541;1830;1818;1792;1770;1106;1117;1117;1100;724;701;675;670;369;397;408;418;
3206072;"Stare Czarnowo (2)";3864;3875;3861;3844;711;696;682;675;2540;2540;2500;2463;1553;1566;1532;1514;987;974;968;949;613;639;679;706;
3206083;"Trzcińsko-Zdrój (3)";5642;5628;5568;5519;1083;1086;1038;1023;3610;3558;3521;3476;2199;2152;2118;2089;1411;1406;1403;1387;949;984;1009;1020;
3206084;"Trzcińsko-Zdrój - miasto (4)";2479;2460;2418;2403;406;427;397;398;1604;1544;1515;1493;924;873;846;832;680;671;669;661;469;489;506;512;
3206085;"Trzcińsko-Zdrój - obszar wiejski (5)";3163;3168;3150;3116;677;659;641;625;2006;2014;2006;1983;1275;1279;1272;1257;731;735;734;726;480;495;503;508;
3206092;"Widuchowa (2)";5600;5598;5565;5558;1170;1123;1074;1057;3639;3670;3654;3634;2268;2308;2300;2287;1371;1362;1354;1347;791;805;837;867;
3207013;"Dziwnów (3)";4079;4024;4012;4004;602;587;580;557;2783;2710;2678;2630;1567;1542;1514;1507;1216;1168;1164;1123;694;727;754;817;
3207014;"Dziwnów - miasto (4)";2779;2736;2724;2714;410;397;396;379;1850;1799;1781;1739;1051;1038;1006;1005;799;761;775;734;519;540;547;596;
3207015;"Dziwnów - obszar wiejski (5)";1300;1288;1288;1290;192;190;184;178;933;911;897;891;516;504;508;502;417;407;389;389;175;187;207;221;
3207023;"Golczewo (3)";6073;6061;5982;5967;1126;1086;1003;986;4044;4008;3957;3928;2457;2467;2456;2446;1587;1541;1501;1482;903;967;1022;1053;
3207024;"Golczewo - miasto (4)";2756;2763;2725;2719;495;477;442;435;1835;1824;1784;1767;1073;1090;1070;1066;762;734;714;701;426;462;499;517;
3207025;"Golczewo - obszar wiejski (5)";3317;3298;3257;3248;631;609;561;551;2209;2184;2173;2161;1384;1377;1386;1380;825;807;787;781;477;505;523;536;
3207033;"Kamień Pomorski (3)";14581;14504;14479;14389;2369;2318;2302;2249;9588;9414;9256;9129;5715;5651;5593;5576;3873;3763;3663;3553;2624;2772;2921;3011;
3207034;"Kamień Pomorski - miasto (4)";9190;9070;9020;8926;1343;1286;1265;1224;6025;5884;5745;5628;3528;3457;3401;3354;2497;2427;2344;2274;1822;1900;2010;2074;
3207035;"Kamień Pomorski - obszar wiejski (5)";5391;5434;5459;5463;1026;1032;1037;1025;3563;3530;3511;3501;2187;2194;2192;2222;1376;1336;1319;1279;802;872;911;937;
3207043;"Międzyzdroje (3)";6661;6596;6583;6543;1024;980;973;924;4442;4351;4272;4206;2499;2452;2423;2409;1943;1899;1849;1797;1195;1265;1338;1413;
3207044;"Międzyzdroje - miasto (4)";5561;5485;5475;5451;813;776;781;743;3692;3608;3531;3486;2076;2029;1998;1996;1616;1579;1533;1490;1056;1101;1163;1222;
3207045;"Międzyzdroje - obszar wiejski (5)";1100;1111;1108;1092;211;204;192;181;750;743;741;720;423;423;425;413;327;320;316;307;139;164;175;191;
3207052;"Świerzno (2)";4323;4315;4356;4310;896;861;868;838;2873;2864;2869;2828;1761;1786;1806;1784;1112;1078;1063;1044;554;590;619;644;
3207063;"Wolin (3)";12414;12447;12339;12281;2284;2288;2241;2192;8241;8151;7964;7849;4828;4794;4733;4723;3413;3357;3231;3126;1889;2008;2134;2240;
3207064;"Wolin - miasto (4)";4968;4999;4919;4867;838;851;836;814;3329;3277;3140;3060;1952;1930;1885;1873;1377;1347;1255;1187;801;871;943;993;
3207065;"Wolin - obszar wiejski (5)";7446;7448;7420;7414;1446;1437;1405;1378;4912;4874;4824;4789;2876;2864;2848;2850;2036;2010;1976;1939;1088;1137;1191;1247;
3208011;"Kołobrzeg (1)";46951;46897;46720;46671;7457;7402;7228;7162;30117;29699;29214;28699;17618;17436;17287;17105;12499;12263;11927;11594;9377;9796;10278;10810;
3208022;"Dygowo (2)";5594;5640;5648;5632;1170;1160;1114;1110;3627;3638;3648;3591;2217;2235;2261;2232;1410;1403;1387;1359;797;842;886;931;
3208033;"Gościno (3)";5276;5235;5186;5163;1174;1169;1083;1054;3343;3262;3258;3221;2087;2026;2041;1995;1256;1236;1217;1226;759;804;845;888;
3208034;"Gościno - miasto (4)";2527;2468;2424;2396;514;516;460;466;1625;1526;1512;1440;990;927;943;887;635;599;569;553;388;426;452;490;
3208035;"Gościno - obszar wiejski (5)";2749;2767;2762;2767;660;653;623;588;1718;1736;1746;1781;1097;1099;1098;1108;621;637;648;673;371;378;393;398;
3208042;"Kołobrzeg (2)";10260;10334;10485;10613;2089;2067;2054;2061;6841;6863;6935;6921;4168;4169;4253;4297;2673;2694;2682;2624;1330;1404;1496;1631;
3208052;"Rymań (2)";4126;4095;4073;4039;867;820;792;771;2668;2677;2672;2639;1702;1703;1702;1664;966;974;970;975;591;598;609;629;
3208062;"Siemyśl (2)";3758;3758;3758;3735;811;772;753;752;2477;2486;2470;2427;1573;1577;1576;1552;904;909;894;875;470;500;535;556;
3208072;"Ustronie Morskie (2)";3668;3665;3697;3663;689;662;661;633;2455;2455;2438;2412;1450;1447;1451;1454;1005;1008;987;958;524;548;598;618;
3209012;"Będzino (2)";8548;8555;8591;8576;1689;1628;1610;1558;5710;5693;5674;5613;3455;3475;3492;3482;2255;2218;2182;2131;1149;1234;1307;1405;
3209022;"Biesiekierz (2)";6283;6420;6473;6556;1297;1287;1261;1267;4194;4281;4306;4313;2539;2615;2635;2657;1655;1666;1671;1656;792;852;906;976;
3209033;"Bobolice (3)";9720;9583;9450;9380;1909;1830;1785;1768;6380;6264;6144;6044;3964;3911;3802;3738;2416;2353;2342;2306;1431;1489;1521;1568;
3209034;"Bobolice - miasto (4)";4271;4218;4204;4167;741;696;705;697;2845;2807;2751;2692;1735;1724;1680;1649;1110;1083;1071;1043;685;715;748;778;
3209035;"Bobolice - obszar wiejski (5)";5449;5365;5246;5213;1168;1134;1080;1071;3535;3457;3393;3352;2229;2187;2122;2089;1306;1270;1271;1263;746;774;773;790;
3209042;"Manowo (2)";6825;6870;6881;6836;1414;1409;1387;1352;4555;4545;4506;4445;2815;2840;2837;2822;1740;1705;1669;1623;856;916;988;1039;
3209052;"Mielno (2)";5011;5056;5082;5006;820;790;796;760;3265;3294;3282;3218;1945;1956;1941;1892;1320;1338;1341;1326;926;972;1004;1028;
3209063;"Polanów (3)";9147;9080;9010;8922;1884;1794;1718;1665;5959;5948;5899;5802;3595;3592;3560;3518;2364;2356;2339;2284;1304;1338;1393;1455;
3209064;"Polanów - miasto (4)";3076;3028;3005;2952;663;594;582;538;2011;2011;1969;1930;1233;1236;1211;1191;778;775;758;739;402;423;454;484;
3209065;"Polanów - obszar wiejski (5)";6071;6052;6005;5970;1221;1200;1136;1127;3948;3937;3930;3872;2362;2356;2349;2327;1586;1581;1581;1545;902;915;939;971;
3209073;"Sianów (3)";13665;13758;13734;13757;2743;2676;2623;2543;9141;9205;9154;9135;5674;5776;5731;5748;3467;3429;3423;3387;1781;1877;1957;2079;
3209074;"Sianów - miasto (4)";6643;6681;6676;6650;1249;1225;1213;1171;4454;4475;4443;4395;2713;2763;2748;2756;1741;1712;1695;1639;940;981;1020;1084;
3209075;"Sianów - obszar wiejski (5)";7022;7077;7058;7107;1494;1451;1410;1372;4687;4730;4711;4740;2961;3013;2983;2992;1726;1717;1728;1748;841;896;937;995;
3209082;"Świeszyno (2)";6614;6659;6741;6811;1395;1318;1323;1276;4446;4511;4544;4578;2761;2823;2837;2861;1685;1688;1707;1717;773;830;874;957;
3210013;"Barlinek (3)";19790;19810;19739;19619;3740;3709;3643;3545;12892;12792;12632;12431;7899;7879;7840;7742;4993;4913;4792;4689;3158;3309;3464;3643;
3210014;"Barlinek - miasto (4)";14277;14263;14180;14053;2566;2539;2506;2406;9248;9128;8960;8797;5637;5611;5555;5456;3611;3517;3405;3341;2463;2596;2714;2850;
3210015;"Barlinek - obszar wiejski (5)";5513;5547;5559;5566;1174;1170;1137;1139;3644;3664;3672;3634;2262;2268;2285;2286;1382;1396;1387;1348;695;713;750;793;
3210022;"Boleszkowice (2)";2930;2937;2912;2900;565;552;550;541;1937;1940;1916;1916;1173;1181;1155;1158;764;759;761;758;428;445;446;443;
3210033;"Dębno (3)";21071;20975;20945;20923;4143;4021;3919;3905;13586;13499;13469;13347;8368;8374;8410;8392;5218;5125;5059;4955;3342;3455;3557;3671;
3210034;"Dębno - miasto (4)";14124;14043;14039;14019;2609;2523;2470;2476;9097;8999;8945;8823;5514;5519;5544;5510;3583;3480;3401;3313;2418;2521;2624;2720;
3210035;"Dębno - obszar wiejski (5)";6947;6932;6906;6904;1534;1498;1449;1429;4489;4500;4524;4524;2854;2855;2866;2882;1635;1645;1658;1642;924;934;933;951;
3210043;"Myślibórz (3)";20662;20584;20429;20312;3655;3620;3540;3454;13473;13304;13055;12810;7965;7900;7750;7670;5508;5404;5305;5140;3534;3660;3834;4048;
3210044;"Myślibórz - miasto (4)";11672;11614;11512;11469;1830;1797;1746;1720;7539;7423;7269;7103;4337;4320;4226;4177;3202;3103;3043;2926;2303;2394;2497;2646;
3210045;"Myślibórz - obszar wiejski (5)";8990;8970;8917;8843;1825;1823;1794;1734;5934;5881;5786;5707;3628;3580;3524;3493;2306;2301;2262;2214;1231;1266;1337;1402;
3210052;"Nowogródek Pomorski (2)";3394;3392;3392;3386;732;703;681;668;2227;2230;2232;2216;1428;1452;1458;1444;799;778;774;772;435;459;479;502;
3211012;"Dobra (Szczecińska) (2)";18357;19301;20144;20866;4299;4550;4733;4899;12275;12783;13252;13604;8053;8379;8654;8803;4222;4404;4598;4801;1783;1968;2159;2363;
3211022;"Kołbaskowo (2)";11251;11599;11829;12108;2628;2683;2684;2716;7684;7894;8026;8161;5360;5459;5526;5607;2324;2435;2500;2554;939;1022;1119;1231;
3211033;"Nowe Warpno (3)";1692;1672;1668;1655;319;298;283;263;1124;1114;1113;1103;668;658;670;674;456;456;443;429;249;260;272;289;
3211034;"Nowe Warpno - miasto (4)";1246;1231;1226;1212;235;220;207;191;818;806;803;790;481;472;483;480;337;334;320;310;193;205;216;231;
3211035;"Nowe Warpno - obszar wiejski (5)";446;441;442;443;84;78;76;72;306;308;310;313;187;186;187;194;119;122;123;119;56;55;56;58;
3211043;"Police (3)";42033;41911;41745;41618;7811;7734;7635;7574;28649;28216;27663;27129;17101;16923;16748;16605;11548;11293;10915;10524;5573;5961;6447;6915;
3211044;"Police - miasto (4)";33816;33625;33404;33236;6130;6090;6008;5964;23234;22767;22246;21713;13844;13633;13474;13328;9390;9134;8772;8385;4452;4768;5150;5559;
3211045;"Police - obszar wiejski (5)";8217;8286;8341;8382;1681;1644;1627;1610;5415;5449;5417;5416;3257;3290;3274;3277;2158;2159;2143;2139;1121;1193;1297;1356;
3212012;"Bielice (2)";3130;3136;3143;3117;670;652;650;621;2048;2055;2044;2037;1293;1305;1295;1285;755;750;749;752;412;429;449;459;
3212022;"Kozielice (2)";2611;2620;2634;2599;530;529;527;503;1659;1655;1662;1645;1023;1036;1035;1027;636;619;627;618;422;436;445;451;
3212033;"Lipiany (3)";6158;6093;6052;6009;1108;1079;1040;1051;3998;3922;3870;3767;2458;2402;2392;2329;1540;1520;1478;1438;1052;1092;1142;1191;
3212034;"Lipiany - miasto (4)";4142;4085;4045;4024;680;670;650;650;2702;2625;2572;2504;1630;1579;1574;1544;1072;1046;998;960;760;790;823;870;
3212035;"Lipiany - obszar wiejski (5)";2016;2008;2007;1985;428;409;390;401;1296;1297;1298;1263;828;823;818;785;468;474;480;478;292;302;319;321;
3212042;"Przelewice (2)";5362;5351;5353;5293;1045;1015;1007;973;3512;3503;3483;3429;2155;2151;2137;2117;1357;1352;1346;1312;805;833;863;891;
3212053;"Pyrzyce (3)";19822;19741;19740;19667;3659;3575;3544;3484;12794;12646;12516;12336;7841;7811;7738;7652;4953;4835;4778;4684;3369;3520;3680;3847;
3212054;"Pyrzyce - miasto (4)";12875;12816;12769;12751;2210;2170;2147;2144;8292;8156;8038;7920;5054;5012;4921;4867;3238;3144;3117;3053;2373;2490;2584;2687;
3212055;"Pyrzyce - obszar wiejski (5)";6947;6925;6971;6916;1449;1405;1397;1340;4502;4490;4478;4416;2787;2799;2817;2785;1715;1691;1661;1631;996;1030;1096;1160;
3212062;"Warnice (2)";3575;3591;3566;3526;682;689;662;637;2366;2361;2349;2320;1487;1484;1474;1448;879;877;875;872;527;541;555;569;
3213011;"Darłowo (1)";14308;14229;14059;14005;2404;2386;2340;2328;9267;9096;8835;8681;5404;5342;5190;5092;3863;3754;3645;3589;2637;2747;2884;2996;
3213021;"Sławno (1)";12992;12898;12825;12690;2351;2319;2281;2233;8174;8043;7893;7723;4948;4897;4826;4758;3226;3146;3067;2965;2467;2536;2651;2734;
3213032;"Darłowo (2)";8026;8030;8048;8011;1699;1663;1618;1559;5247;5237;5264;5259;3287;3270;3280;3284;1960;1967;1984;1975;1080;1130;1166;1193;
3213042;"Malechowo (2)";6589;6585;6506;6453;1406;1353;1324;1269;4231;4253;4197;4174;2643;2648;2604;2606;1588;1605;1593;1568;952;979;985;1010;
3213052;"Postomino (2)";7068;7079;7053;7036;1568;1545;1501;1458;4549;4548;4524;4520;2866;2871;2856;2862;1683;1677;1668;1658;951;986;1028;1058;
3213062;"Sławno (2)";8975;9034;8998;8993;1952;1928;1882;1857;5916;5947;5905;5884;3777;3836;3803;3781;2139;2111;2102;2103;1107;1159;1211;1252;
3214011;"Stargard (1)";69724;69328;68922;68670;11929;11757;11587;11574;45497;44660;43754;42821;27622;27331;27021;26602;17875;17329;16733;16219;12298;12911;13581;14275;
3214023;"Chociwel (3)";5992;5962;6020;5942;1109;1092;1095;1054;3961;3913;3931;3887;2408;2383;2400;2379;1553;1530;1531;1508;922;957;994;1001;
3214024;"Chociwel - miasto (4)";3216;3206;3237;3196;549;549;563;541;2215;2181;2166;2133;1314;1302;1302;1287;901;879;864;846;452;476;508;522;
3214025;"Chociwel - obszar wiejski (5)";2776;2756;2783;2746;560;543;532;513;1746;1732;1765;1754;1094;1081;1098;1092;652;651;667;662;470;481;486;479;
3214033;"Dobrzany (3)";5061;5065;5048;5037;980;951;927;904;3305;3308;3283;3263;2041;2069;2052;2035;1264;1239;1231;1228;776;806;838;870;
3214034;"Dobrzany - miasto (4)";2378;2387;2352;2361;386;372;353;351;1623;1630;1591;1582;968;982;957;949;655;648;634;633;369;385;408;428;
3214035;"Dobrzany - obszar wiejski (5)";2683;2678;2696;2676;594;579;574;553;1682;1678;1692;1681;1073;1087;1095;1086;609;591;597;595;407;421;430;442;
3214042;"Dolice (2)";8093;8081;8025;8018;1732;1662;1603;1589;5234;5258;5196;5162;3282;3309;3285;3283;1952;1949;1911;1879;1127;1161;1226;1267;
3214053;"Ińsko (3)";3589;3554;3557;3503;661;591;590;564;2300;2306;2293;2247;1364;1380;1382;1348;936;926;911;899;628;657;674;692;
3214054;"Ińsko - miasto (4)";2066;2035;2031;2010;359;309;300;287;1347;1343;1334;1310;789;789;793;777;558;554;541;533;360;383;397;413;
3214055;"Ińsko - obszar wiejski (5)";1523;1519;1526;1493;302;282;290;277;953;963;959;937;575;591;589;571;378;372;370;366;268;274;277;279;
3214062;"Kobylanka (2)";4761;4905;5057;5190;968;974;997;1014;3165;3250;3305;3373;1942;2003;2053;2089;1223;1247;1252;1284;628;681;755;803;
3214082;"Marianowo (2)";3234;3211;3190;3169;670;661;637;644;2115;2098;2087;2055;1327;1310;1305;1295;788;788;782;760;449;452;466;470;
3214092;"Stara Dąbrowa (2)";3718;3711;3733;3729;820;791;784;776;2440;2446;2462;2456;1518;1539;1558;1538;922;907;904;918;458;474;487;497;
3214102;"Stargard (2)";12380;12576;12692;12841;2650;2663;2629;2655;8269;8378;8449;8503;5294;5372;5423;5469;2975;3006;3026;3034;1461;1535;1614;1683;
3214113;"Suchań (3)";4369;4333;4349;4323;834;810;802;776;2874;2851;2856;2833;1782;1769;1776;1767;1092;1082;1080;1066;661;672;691;714;
3214114;"Suchań - miasto (4)";1475;1466;1459;1453;246;248;240;241;1004;986;979;969;611;599;595;596;393;387;384;373;225;232;240;243;
3214115;"Suchań - obszar wiejski (5)";2894;2867;2890;2870;588;562;562;535;1870;1865;1877;1864;1171;1170;1181;1171;699;695;696;693;436;440;451;471;
3215011;"Szczecinek (1)";40723;40620;40535;40440;7099;7032;6927;6809;26247;25862;25523;25179;15797;15680;15600;15469;10450;10182;9923;9710;7377;7726;8085;8452;
3215023;"Barwice (3)";8885;8858;8754;8710;1805;1737;1682;1641;5837;5789;5698;5640;3533;3546;3482;3499;2304;2243;2216;2141;1243;1332;1374;1429;
3215024;"Barwice - miasto (4)";3839;3851;3800;3766;716;689;665;648;2548;2536;2489;2454;1526;1545;1501;1496;1022;991;988;958;575;626;646;664;
3215025;"Barwice - obszar wiejski (5)";5046;5007;4954;4944;1089;1048;1017;993;3289;3253;3209;3186;2007;2001;1981;2003;1282;1252;1228;1183;668;706;728;765;
3215033;"Biały Bór (3)";5381;5345;5342;5357;1040;1042;1039;1022;3568;3486;3428;3420;2140;2041;2007;2009;1428;1445;1421;1411;773;817;875;915;
3215034;"Biały Bór - miasto (4)";2246;2229;2210;2210;396;440;441;438;1525;1449;1405;1393;886;804;766;770;639;645;639;623;325;340;364;379;
3215035;"Biały Bór - obszar wiejski (5)";3135;3116;3132;3147;644;602;598;584;2043;2037;2023;2027;1254;1237;1241;1239;789;800;782;788;448;477;511;536;
3215043;"Borne Sulinowo (3)";9862;9856;9818;9807;1914;1831;1791;1723;6080;6065;6009;6008;3759;3795;3715;3725;2321;2270;2294;2283;1868;1960;2018;2076;
3215044;"Borne Sulinowo - miasto (4)";4850;4905;4903;4880;902;888;878;816;2811;2815;2808;2814;1772;1802;1759;1754;1039;1013;1049;1060;1137;1202;1217;1250;
3215045;"Borne Sulinowo - obszar wiejski (5)";5012;4951;4915;4927;1012;943;913;907;3269;3250;3201;3194;1987;1993;1956;1971;1282;1257;1245;1223;731;758;801;826;
3215052;"Grzmiąca (2)";5027;5007;4989;4926;1062;988;961;916;3208;3237;3192;3147;1955;1989;1965;1939;1253;1248;1227;1208;757;782;836;863;
3215062;"Szczecinek (2)";9478;9418;9420;9338;2090;1996;1934;1882;6210;6195;6197;6116;3964;3958;3962;3903;2246;2237;2235;2213;1178;1227;1289;1340;
3216011;"Świdwin (1)";15798;15725;15588;15554;2869;2820;2757;2716;10350;10217;10032;9913;6282;6211;6119;6080;4068;4006;3913;3833;2579;2688;2799;2925;
3216022;"Brzeżno (2)";2906;2880;2849;2849;606;598;575;598;1871;1840;1829;1787;1136;1121;1118;1097;735;719;711;690;429;442;445;464;
3216033;"Połczyn-Zdrój (3)";15970;15813;15749;15601;2739;2640;2577;2515;10359;10173;10024;9845;6191;6150;6131;6027;4168;4023;3893;3818;2872;3000;3148;3241;
3216034;"Połczyn-Zdrój - miasto (4)";8529;8444;8418;8327;1319;1272;1237;1206;5457;5325;5242;5136;3194;3164;3152;3101;2263;2161;2090;2035;1753;1847;1939;1985;
3216035;"Połczyn-Zdrój - obszar wiejski (5)";7441;7369;7331;7274;1420;1368;1340;1309;4902;4848;4782;4709;2997;2986;2979;2926;1905;1862;1803;1783;1119;1153;1209;1256;
3216042;"Rąbino (2)";3840;3836;3813;3766;759;749;732;724;2460;2454;2433;2370;1468;1480;1465;1435;992;974;968;935;621;633;648;672;
3216052;"Sławoborze (2)";4241;4215;4246;4173;833;816;816;772;2794;2775;2774;2725;1702;1685;1701;1684;1092;1090;1073;1041;614;624;656;676;
3216062;"Świdwin (2)";6145;6113;6098;6051;1258;1219;1166;1140;4042;4033;4035;3953;2460;2461;2473;2444;1582;1572;1562;1509;845;861;897;958;
3217011;"Wałcz (1)";26417;26231;26033;25882;4647;4553;4442;4351;17158;16847;16548;16263;10375;10249;10094;9981;6783;6598;6454;6282;4612;4831;5043;5268;
3217023;"Człopa (3)";5053;5066;5046;5051;1011;1005;965;968;3259;3251;3243;3212;1987;1988;1998;2015;1272;1263;1245;1197;783;810;838;871;
3217024;"Człopa - miasto (4)";2335;2342;2345;2363;431;424;413;422;1509;1502;1500;1485;890;881;901;916;619;621;599;569;395;416;432;456;
3217025;"Człopa - obszar wiejski (5)";2718;2724;2701;2688;580;581;552;546;1750;1749;1743;1727;1097;1107;1097;1099;653;642;646;628;388;394;406;415;
3217033;"Mirosławiec (3)";5614;5577;5530;5516;1222;1192;1165;1152;3619;3560;3481;3445;2282;2257;2240;2229;1337;1303;1241;1216;773;825;884;919;
3217034;"Mirosławiec - miasto (4)";3072;3037;3040;3071;642;629;626;643;1985;1938;1906;1899;1211;1188;1198;1213;774;750;708;686;445;470;508;529;
3217035;"Mirosławiec - obszar wiejski (5)";2542;2540;2490;2445;580;563;539;509;1634;1622;1575;1546;1071;1069;1042;1016;563;553;533;530;328;355;376;390;
3217043;"Tuczno (3)";5090;5053;5064;5026;966;933;935;917;3256;3236;3224;3171;1985;2012;2014;1992;1271;1224;1210;1179;868;884;905;938;
3217044;"Tuczno - miasto (4)";1985;1974;1956;1936;351;329;323;315;1270;1268;1240;1211;739;762;754;747;531;506;486;464;364;377;393;410;
3217045;"Tuczno - obszar wiejski (5)";3105;3079;3108;3090;615;604;612;602;1986;1968;1984;1960;1246;1250;1260;1245;740;718;724;715;504;507;512;528;
3217052;"Wałcz (2)";12669;12670;12675;12732;2720;2612;2585;2528;8322;8355;8327;8344;5176;5226;5217;5268;3146;3129;3110;3076;1627;1703;1763;1860;
3218013;"Dobra (3)";4516;4482;4478;4473;868;818;840;826;2950;2940;2887;2864;1833;1841;1809;1796;1117;1099;1078;1068;698;724;751;783;
3218014;"Dobra - miasto (4)";2362;2347;2338;2331;425;414;423;431;1537;1503;1469;1442;927;919;909;895;610;584;560;547;400;430;446;458;
3218015;"Dobra - obszar wiejski (5)";2154;2135;2140;2142;443;404;417;395;1413;1437;1418;1422;906;922;900;901;507;515;518;521;298;294;305;325;
3218023;"Łobez (3)";14455;14356;14283;14291;2656;2625;2551;2532;9375;9213;9077;9001;5619;5525;5516;5512;3756;3688;3561;3489;2424;2518;2655;2758;
3218024;"Łobez - miasto (4)";10549;10438;10409;10404;1821;1795;1752;1741;6857;6683;6577;6495;4047;3949;3939;3929;2810;2734;2638;2566;1871;1960;2080;2168;
3218025;"Łobez - obszar wiejski (5)";3906;3918;3874;3887;835;830;799;791;2518;2530;2500;2506;1572;1576;1577;1583;946;954;923;923;553;558;575;590;
3218032;"Radowo Małe (2)";3729;3708;3677;3694;728;700;700;701;2427;2417;2371;2362;1473;1472;1441;1446;954;945;930;916;574;591;606;631;
3218043;"Resko (3)";8311;8229;8196;8135;1624;1571;1550;1528;5289;5215;5148;5071;3120;3114;3115;3068;2169;2101;2033;2003;1398;1443;1498;1536;
3218044;"Resko - miasto (4)";4398;4356;4325;4268;721;702;700;680;2863;2804;2741;2677;1610;1599;1595;1559;1253;1205;1146;1118;814;850;884;911;
3218045;"Resko - obszar wiejski (5)";3913;3873;3871;3867;903;869;850;848;2426;2411;2407;2394;1510;1515;1520;1509;916;896;887;885;584;593;614;625;
3218053;"Węgorzyno (3)";7200;7191;7170;7098;1403;1383;1359;1327;4599;4567;4527;4457;2808;2814;2809;2761;1791;1753;1718;1696;1198;1241;1284;1314;
3218054;"Węgorzyno - miasto (4)";2906;2909;2902;2883;568;562;539;533;1890;1866;1857;1823;1146;1149;1166;1149;744;717;691;674;448;481;506;527;
3218055;"Węgorzyno - obszar wiejski (5)";4294;4282;4268;4215;835;821;820;794;2709;2701;2670;2634;1662;1665;1643;1612;1047;1036;1027;1022;750;760;778;787;
3261011;"Koszalin (1)";109343;109170;108605;107970;17023;16966;16966;16995;69972;68889;67321;65752;42981;42786;42075;41234;26991;26103;25246;24518;22348;23315;24318;25223;
3262011;"Szczecin (1)";408913;408172;407180;405657;63412;63198;63012;63114;262469;258846;254941;250253;161778;161005;159739;157557;100691;97841;95202;92696;83032;86128;89227;92290;
3263011;"Świnoujście (1)";41509;41371;41276;41152;6216;6080;5944;5856;26920;26528;26162;25772;15677;15577;15501;15338;11243;10951;10661;10434;8373;8763;9170;9524;
